30 100
GTAACCCAGTAGTTGTTATCCTTCATAGGG|ACACGCATCCAACTAGAGTCATGATATCTC
GTCTGGATACAAGTCGTCGAGACTGATACC|AGAAGGAACCCGTCTCGAGACTGATACCCT
GAGACTGATACCCTTAATTGCAGAAGGATG|TCTTAAGATACAATACGGTCTCGAGACTGA
GGGGGTCATACGACCCAATCAGAGCCGAGA|ACCCTTAATTGCAGAAGGACCCTTAATTGC
TACCCTTAATTGCAGAAGGAGACGCGTTCG|CTGATACCCTTAATTGCAGAAGGAAATTTA
CGTTCGTGATACTTCGAGACTGATACCCTT|AATTTAAAGCCATACTAGAGTTGGCATCGA
CTTTCCGAGGCATAGCAGTCGCCATCAAGC|GTAGGTCATTTCCCCACGCTGCGACCGAAG
ACGCATCCAACTAGAGTCATGATATCTCGA|GGTTGTCCCTCATGGGCGCTCCGTATGGCC
CCTGGGGGTCATACGACCCAATCAGAGCCG|GATACCCTTAATTGCAGAAGGACCCTTAAT
GAGACTGATACCCTTAATTGCAGAAGGAAT|AAAGTCTAAAAAATCGAGACTGATACCCTT
CTTAATTGCAGAAGGAATCGTGACCATTCC|CCCCGGCCTACTAAGTAAATAGCACCGACT
TGATATCGAGACTGATACCCTTAATTGCAG|GTTTCACAGGATGTGGCCTATGCGTGTTAG
TCTAAAAAATCGAGACTGATACCCTTAATT|GCGATCGCCCCGATGTTCCTATCCGATTCC
CAAGCACTTCCGGATCAGCGTCTCAGGCAG|CGAAGATTGATAGTGTACATTAATAGACAA
CTGCGACCGAAGATTGATAGTGTACATTAA|CTGTCTGGATACAAGTCGTCGAGACTGATA
ACTGATACCCTTAATTGCAGAAGGACGGAG|CGGGGCTAGCAAAGATGCTTGGCCTGTTTA
CGAGACTGATACCCTTAATTGCAGAAGGAT|CTAGAGTTGGCATCGAGACTGATATCGAGA
AGATTGATAGTGTACATTAATAGACAAGTT|ACAAGTCGTCGAGACTGATACCCTTAATTG
GAGAGACTGATACCCTTAATTGCAGAAGGA|GGAAAGTCTAAAAAATCGAGACTGATACCC
GAGACTGATACCCTTAATTGCAGAAGGAAA|GACGGTCTAGTCGAGACTGATACCCTTAAT
TTACACGCATCCAACTAGAGTCATGATATC|ATAGGGTTGTCCCTCATGGGCGCTCCGTAT
GAGTCATGATATCTCGACCGCGATCGCCCC|GGGCGCTCCGTATGGCCCAGCACGGGGTAT
ATACCCTTAATTGCAGAAGGAATCGCCTCG|AAAAAATCGAGACTGATACCCTTAATTGCA
GTTCGTGATACTTCGAGACTGATACCCTTA|ATTTAAAGCCATACTAGAGTTGGCATCGAG
TCTCGACCGCGATCGCCCCGATGTTCCTAT|ATGGCCCAGCACGGGGTATGTACCGATAGT
GAGTTGGCATCGAGACTGATATCGAGACTG|GTGAATAGAGGAATGAGTTTCACAGGATGT
AGCCATACTAGAGTTGGCATCGAGACTGAT|AAGGATGTCTGTGAATAGAGGAATGAGTTT
TGACCATTCCCCGACGGTCTAGTCGAGACT|AGCACCGACTCTAGTCTCCTTAACTCTTAA
AGATGCTTGGCCTGTTTACACGCATCCAAC|TTGCGGCCCTCTACGATAGGGTTGTCCCTC
CAAACCCCTCAGAGCGGTAGGCATAGATCA|GCGTGCACAGCGTCTTGTTCAGTAGGTGGA
GTCCTGGGGGTCATACGACCCAATCAGAGC|CTGATACCCTTAATTGCAGAAGGACCCTTA
GTGCCAGCTCGGCCTATTCTATACTAGGTG|TACCCTTAATTGCAGAAGGAGACAAGATGA
AGGAACCCGTCTCGAGACTGATACCCTTAA|CAGAAGGAGACGCGTTCGTGATACTTCGAG
AGAAGGACCCTTAATTGCAGAAGGAATCGT|AGGAGAGCCCCCCGGCCTACTAAGTAAATA
AGAAGGAGAGACTGATACCCTTAATTGCAG|ATACCCTTAATTGCAGAAGGATGTCCTGGG
AACCCAGTAGTTGTTATCCTTCATAGGGAA|ACGCATCCAACTAGAGTCATGATATCTCGA
GATACCCTTAATTGCAGAAGGAAATTTAAA|CTAGTCGAGACTGATACCCTTAATTGCAGA
TCCTGGGGGTCATACGACCCAATCAGAGCC|TGATACCCTTAATTGCAGAAGGACCCTTAA
CCCCAATCGTGATGATTTTTGGGCCGGGGC|ACCTACGTGACACCCTGGATGTGGGTTTAT
AGAAGGAGACAAGATGAGCGCCGCCCGTTC|GGGGTCATACGACCCAATCAGAGCCGAGAT
TGCAGAAGGACCCTTAATTGCAGAAGGAAT|GTTAGGAGAGCCCCCCGGCCTACTAAGTAA
TCGAGACTGATACCCTTAATTGCAGAAGGA|GCAGAAGGACAACCCCCAATCGTGATGATT
ATGCACCAGAACTTGTGGACCTGTCTGGAT|CGAGACTGATACCCTTAATTGCAGAAGGAA
CTACCTCGGGTGGCGCAGTGGTGTCGAAAG|TATTCTATACTAGGTGGAAGCTTTAGAGCC
CGAGACTGATACCCTTAATTGCAGAAGGAC|CAGGATGTGGCCTATGCGTGTTAGGAGAGC
TGAGTTTCACAGGATGTGGCCTATGCGTGT|AGGAGAGACTGATACCCTTAATTGCAGAAG
CTTAATTGCAGAAGGAACCCGTCTCGAGAC|TACCCTTAATTGCAGAAGGAGACGCGTTCG
ATCGCCTCGAGACTGATACCCTTAATTGCA|TTAATTGCAGAAGGACAACCCCCAATCGTG
TGCAGAAGGAATCGCCTCGAGACTGATACC|ACTGATACCCTTAATTGCAGAAGGACAACC
AGTTGGCATCGAGACTGATATCGAGACTGA|TGAATAGAGGAATGAGTTTCACAGGATGTG
AATTGCAGAAGGAGAGACTGATACCCTTAA|ATCCTTCATAGGGAAAGTCTAAAAAATCGA
CGACCCAATCAGAGCCGAGATAGAAAAAGT|GCAGAAGGACCCTTAATTGCAGAAGGAATC
TAAGTAAATAGCACCGACTCTAGTCTCCTT|CCTTAATTGCAGAAGGATATCGAGACTGAT
GCAGAAGGAGACGCGTTCGTGATACTTCGA|AATTGCAGAAGGAAATTTAAAGCCATACTA
ACTGATACCCTTAATTGCAGAAGGAGACGC|CGAGACTGATACCCTTAATTGCAGAAGGAA
GTGGACCTGTCTGGATACAAGTCGTCGAGA|TTAATTGCAGAAGGAACCCGTCTCGAGACT
CCAACTAGAGTCATGATATCTCGACCGCGA|CCCTCATGGGCGCTCCGTATGGCCCAGCAC
CCCGTTCGCACCTATCTCCCAAATCGAGAC|CCGAGATAGAAAAAGTCCGTCGTATGTTCG
TTATCCTTCATAGGGAAAGTCTAAAAAATC|GAGTCATGATATCTCGACCGCGATCGCCCC
GCCGAGATAGAAAAAGTCCGTCGTATGTTC|TAATTGCAGAAGGAATCGTGACCATTCCCC
ATACTAGAGTTGGCATCGAGACTGATATCG|ATGTCTGTGAATAGAGGAATGAGTTTCACA
ATAGAGGAATGAGTTTCACAGGATGTGGCC|AATTGCAGAAGGAGAGACTGATACCCTTAA
TCGACCGCGATCGCCCCGATGTTCCTATCC|GGCCCAGCACGGGGTATGTACCGATAGTGG
GTTCGAGACTGATACCCTTAATTGCAGAAG|CCCCGACGGTCTAGTCGAGACTGATACCCT
CCCTTAATTGCAGAAGGATGTCCTGGGGGT|ATCGAGACTGATATCGAGACTGATACCCTT
GCTGACGTTAAAGAGGCTTCGCAGGTCGAC|AGTTGTCCAATGCTAGTAAGAGGATTATTT
ACTTCGAGACTGATACCCTTAATTGCAGAA|CATACTAGAGTTGGCATCGAGACTGATATC
GACCCAATCAGAGCCGAGATAGAAAAAGTC|CAGAAGGACCCTTAATTGCAGAAGGAATCG
AGAGGCTTCGCAGGTCGACACGCATATCAA|GCTAGTAAGAGGATTATTTAACTACCTCGG
TGGACCTGTCTGGATACAAGTCGTCGAGAC|TAATTGCAGAAGGAACCCGTCTCGAGACTG
ATATCGAGACTGATACCCTTAATTGCAGAA|TTTTGGGCCGGGGCTAGCAAAGATGCTTGG
CCTATTCTATACTAGGTGGAAGCTTTAGAG|CAGAAGGAGACAAGATGAGCGCCGCCCGTT
GATCAGCGTCTCAGGCAGCTGACGTTAAAG|GTGTACATTAATAGACAAGTTGTCCAATGC
TCGAGACTGATACCCTTAATTGCAGAAGGA|ACTAGAGTTGGCATCGAGACTGATATCGAG
CTGATACCCTTAATTGCAGAAGGATATCGA|GGACAACCCCCAATCGTGATGATTTTTGGG
TCGAGACTGATACCCTTAATTGCAGAAGGA|GCGTTCGTGATACTTCGAGACTGATACCCT
CTCGGTATCCTCTCGAGACTGATACCCTTA|GCACCTATCTCCCAAATCGAGACTGATACC
GGACGGAGTAACCCAGTAGTTGTTATCCTT|CCTGTTTACACGCATCCAACTAGAGTCATG
GTGACCATTCCCCGACGGTCTAGTCGAGAC|TAGCACCGACTCTAGTCTCCTTAACTCTTA
GTCGAAAGTACCATTCGTGGATGCACCAGA|TTAGAGCCTCGGTATCCTCTCGAGACTGAT
TGATAGTGTACATTAATAGACAAGTTGTCC|GTCGTCGAGACTGATACCCTTAATTGCAGA
GGGCCGGGGCTAGCAAAGATGCTTGGCCTG|GTGGGTTTATTAGTCATTGCGGCCCTCTAC
AAGCTTTAGAGCCTCGGTATCCTCTCGAGA|CGCCGCCCGTTCGCACCTATCTCCCAAATC
CAGTAGTTGTTATCCTTCATAGGGAAAGTC|ATCCAACTAGAGTCATGATATCTCGACCGC
GACTGATACCCTTAATTGCAGAAGGAACTA|CTGATACCCTTAATTGCAGAAGGAGAGACT
AGTGGTGTCGAAAGTACCATTCGTGGATGC|GAAGCTTTAGAGCCTCGGTATCCTCTCGAG
TCATACGACCCAATCAGAGCCGAGATAGAA|TAATTGCAGAAGGACCCTTAATTGCAGAAG
GAAGGACAACCCCCAATCGTGATGATTTTT|TGGTACTCGCACCTACGTGACACCCTGGAT
GGACAACCCCCAATCGTGATGATTTTTGGG|TACTCGCACCTACGTGACACCCTGGATGTG
GGAGACGCGTTCGTGATACTTCGAGACTGA|AGAAGGAAATTTAAAGCCATACTAGAGTTG
GATATCTCGACCGCGATCGCCCCGATGTTC|CCGTATGGCCCAGCACGGGGTATGTACCGA
AGAGTTGGCATCGAGACTGATATCGAGACT|TGTGAATAGAGGAATGAGTTTCACAGGATG
GTGCACAGCGTCTTGTTCAGTAGGTGGACA|GCAGTGGTGTCGAAAGTACCATTCGTGGAT
ACGCTGCGACCGAAGATTGATAGTGTACAT|GACCTGTCTGGATACAAGTCGTCGAGACTG
GGATGTGGCCTATGCGTGTTAGGAGAGCCC|ATACCCTTAATTGCAGAAGGAATCGCCTCG
GTTCGCACCTATCTCCCAAATCGAGACTGA|AGATAGAAAAAGTCCGTCGTATGTTCGAGA
CACCGACTCTAGTCTCCTTAACTCTTAAGA|GAAGGATATCGAGACTGATACCCTTAATTG
ATTGCAGAAGGATGTCCTGGGGGTCATACG|ACTGATATCGAGACTGATACCCTTAATTGC
TTAATTGCAGAAGGATGTCCTGGGGGTCAT|GAGACTGATATCGAGACTGATACCCTTAAT
AATCGCCTCGAGACTGATACCCTTAATTGC|CTTAATTGCAGAAGGACAACCCCCAATCGT
GAAGGAACTATGGTGCCAGCTCGGCCTATT|AGGAGAGACTGATACCCTTAATTGCAGAAG
CAACCTGCGTGCACAGCGTCTTGTTCAGTA|CGGGTGGCGCAGTGGTGTCGAAAGTACCAT
CGTGATGATTTTTGGGCCGGGGCTAGCAAA|TGACACCCTGGATGTGGGTTTATTAGTCAT
AATTGCAGAAGGAGAGACTGATACCCTTAA|AGACTGATACCCTTAATTGCAGAAGGATGT
GGATACAAGTCGTCGAGACTGATACCCTTA|GGAACCCGTCTCGAGACTGATACCCTTAAT
GCAGCTGACGTTAAAGAGGCTTCGCAGGTC|ACAAGTTGTCCAATGCTAGTAAGAGGATTA
GAGACTGATACCCTTAATTGCAGAAGGACG|GGCCGGGGCTAGCAAAGATGCTTGGCCTGT
GGATGCACCAGAACTTGTGGACCTGTCTGG|CTCGAGACTGATACCCTTAATTGCAGAAGG
AAGCCATACTAGAGTTGGCATCGAGACTGA|GAAGGATGTCTGTGAATAGAGGAATGAGTT
GACAACCCCCAATCGTGATGATTTTTGGGC|ACTCGCACCTACGTGACACCCTGGATGTGG
TTTCCCCACGCTGCGACCGAAGATTGATAG|ACTTGTGGACCTGTCTGGATACAAGTCGTC
CGCATATCAACCTGCGTGCACAGCGTCTTG|ACTACCTCGGGTGGCGCAGTGGTGTCGAAA
CCCTTAATTGCAGAAGGAACCCGTCTCGAG|GATACCCTTAATTGCAGAAGGAGACGCGTT
CCCCGGCCTACTAAGTAAATAGCACCGACT|GAGACTGATACCCTTAATTGCAGAAGGATA
ACTGATATCGAGACTGATACCCTTAATTGC|GAGTTTCACAGGATGTGGCCTATGCGTGTT
TGATACCCTTAATTGCAGAAGGATGTCTGT|AGATACAATACGGTCTCGAGACTGATACCC
CCTTAATTGCAGAAGGAACTATGGTGCCAG|TTAATTGCAGAAGGAGAGACTGATACCCTT
CAGGCAGCTGACGTTAAAGAGGCTTCGCAG|TAGACAAGTTGTCCAATGCTAGTAAGAGGA
GTCGCCATCAAGCACTTCCGGATCAGCGTC|GCTGCGACCGAAGATTGATAGTGTACATTA
ACCCTTAATTGCAGAAGGACCCTTAATTGC|CCTATGCGTGTTAGGAGAGCCCCCCGGCCT
ATCAATCTTTCCGAGGCATAGCAGTCGCCA|TGGACAGTAGGTCATTTCCCCACGCTGCGA
AATAGAGGAATGAGTTTCACAGGATGTGGC|TAATTGCAGAAGGAGAGACTGATACCCTTA
GGAGAGCCCCCCGGCCTACTAAGTAAATAG|ATCGCCTCGAGACTGATACCCTTAATTGCA
ATGATTTTTGGGCCGGGGCTAGCAAAGATG|ACCCTGGATGTGGGTTTATTAGTCATTGCG
CTGCGTGCACAGCGTCTTGTTCAGTAGGTG|TGGCGCAGTGGTGTCGAAAGTACCATTCGT
CATCCAACTAGAGTCATGATATCTCGACCG|TGTCCCTCATGGGCGCTCCGTATGGCCCAG
TTAAGATACAATACGGTCTCGAGACTGATA|TAATTGCAGAAGGACGGAGTAACCCAGTAG
TACCCTTAATTGCAGAAGGAATCGCCTCGA|AAAAATCGAGACTGATACCCTTAATTGCAG
AAAGATGCTTGGCCTGTTTACACGCATCCA|CATTGCGGCCCTCTACGATAGGGTTGTCCC
TGATGATTTTTGGGCCGGGGCTAGCAAAGA|ACACCCTGGATGTGGGTTTATTAGTCATTG
AGGTGGAAGCTTTAGAGCCTCGGTATCCTC|GATGAGCGCCGCCCGTTCGCACCTATCTCC
GCAGTGGTGTCGAAAGTACCATTCGTGGAT|TGGAAGCTTTAGAGCCTCGGTATCCTCTCG
CTCGACCGCGATCGCCCCGATGTTCCTATC|TGGCCCAGCACGGGGTATGTACCGATAGTG
TGCAGAAGGAGACGCGTTCGTGATACTTCG|TAATTGCAGAAGGAAATTTAAAGCCATACT
CATTCCCCGACGGTCTAGTCGAGACTGATA|CCGACTCTAGTCTCCTTAACTCTTAAGATA
TTTTGGGCCGGGGCTAGCAAAGATGCTTGG|GGATGTGGGTTTATTAGTCATTGCGGCCCT
TTGCAGAAGGAACCCGTCTCGAGACTGATA|TTAATTGCAGAAGGAGACGCGTTCGTGATA
TTGCAGAAGGAAATTTAAAGCCATACTAGA|TGATACCCTTAATTGCAGAAGGATGTCTGT
TGCTAGTAAGAGGATTATTTAACTACCTCG|GAACTATGGTGCCAGCTCGGCCTATTCTAT
ACCCTTAATTGCAGAAGGATATCGAGACTG|ACCCCCAATCGTGATGATTTTTGGGCCGGG
TAGATCAATCTTTCCGAGGCATAGCAGTCG|AGGTGGACAGTAGGTCATTTCCCCACGCTG
CCCTTAATTGCAGAAGGAGAGACTGATACC|TTGTTATCCTTCATAGGGAAAGTCTAAAAA
CCTACTAAGTAAATAGCACCGACTCTAGTC|GATACCCTTAATTGCAGAAGGATATCGAGA
ATGTTCGAGACTGATACCCTTAATTGCAGA|TTCCCCGACGGTCTAGTCGAGACTGATACC
CAGAAGGAAATTTAAAGCCATACTAGAGTT|TACCCTTAATTGCAGAAGGATGTCTGTGAA
ATACCCTTAATTGCAGAAGGAACTATGGTG|ACCCTTAATTGCAGAAGGAGAGACTGATAC
TATGCGTGTTAGGAGAGCCCCCCGGCCTAC|TTGCAGAAGGAATCGCCTCGAGACTGATAC
CAATGCTAGTAAGAGGATTATTTAACTACC|AAGGAACTATGGTGCCAGCTCGGCCTATTC
AGCAAAGATGCTTGGCCTGTTTACACGCAT|AGTCATTGCGGCCCTCTACGATAGGGTTGT
GACAAGATGAGCGCCGCCCGTTCGCACCTA|TACGACCCAATCAGAGCCGAGATAGAAAAA
TGGCGCAGTGGTGTCGAAAGTACCATTCGT|TAGGTGGAAGCTTTAGAGCCTCGGTATCCT
TCCGTCGTATGTTCGAGACTGATACCCTTA|CGTGACCATTCCCCGACGGTCTAGTCGAGA
GATTGATAGTGTACATTAATAGACAAGTTG|CAAGTCGTCGAGACTGATACCCTTAATTGC
CTGTGAATAGAGGAATGAGTTTCACAGGAT|ACCCTTAATTGCAGAAGGAGAGACTGATAC
AGGACCCTTAATTGCAGAAGGAATCGTGAC|AGAGCCCCCCGGCCTACTAAGTAAATAGCA
GATGTCCTGGGGGTCATACGACCCAATCAG|AGACTGATACCCTTAATTGCAGAAGGACCC
GGTCTAGTCGAGACTGATACCCTTAATTGC|CTCCTTAACTCTTAAGATACAATACGGTCT
TTAATTGCAGAAGGAATCGTGACCATTCCC|CCCGGCCTACTAAGTAAATAGCACCGACTC
AGACTGATACCCTTAATTGCAGAAGGAGAG|TTCGTGATACTTCGAGACTGATACCCTTAA
AAGGACAACCCCCAATCGTGATGATTTTTG|GGTACTCGCACCTACGTGACACCCTGGATG
CGGTCTAGTCGAGACTGATACCCTTAATTG|TCTCCTTAACTCTTAAGATACAATACGGTC
AAGAGGATTATTTAACTACCTCGGGTGGCG|GGTGCCAGCTCGGCCTATTCTATACTAGGT
AGACTGATACCCTTAATTGCAGAAGGAGAG|ACCCAGTAGTTGTTATCCTTCATAGGGAAA
CCTTAATTGCAGAAGGAAATTTAAAGCCAT|CGAGACTGATACCCTTAATTGCAGAAGGAT
ATTTCCCCACGCTGCGACCGAAGATTGATA|AACTTGTGGACCTGTCTGGATACAAGTCGT
AGGTCGACACGCATATCAACCTGCGTGCAC|GATTATTTAACTACCTCGGGTGGCGCAGTG
AAGGAAATTTAAAGCCATACTAGAGTTGGC|CCTTAATTGCAGAAGGATGTCTGTGAATAG
GCGCCGCCCGTTCGCACCTATCTCCCAAAT|TCAGAGCCGAGATAGAAAAAGTCCGTCGTA
TTAAAGCCATACTAGAGTTGGCATCGAGAC|GCAGAAGGATGTCTGTGAATAGAGGAATGA
ACTGATACCCTTAATTGCAGAAGGAACCCG|CGAGACTGATACCCTTAATTGCAGAAGGAG
TGATACCCTTAATTGCAGAAGGACGGAGTA|GGGCTAGCAAAGATGCTTGGCCTGTTTACA
ATTTTTGGGCCGGGGCTAGCAAAGATGCTT|CTGGATGTGGGTTTATTAGTCATTGCGGCC
TTGCAGAAGGAGACGCGTTCGTGATACTTC|TTAATTGCAGAAGGAAATTTAAAGCCATAC
AATCAGAGCCGAGATAGAAAAAGTCCGTCG|GGACCCTTAATTGCAGAAGGAATCGTGACC
TCAGAGCGGTAGGCATAGATCAATCTTTCC|AGCGTCTTGTTCAGTAGGTGGACAGTAGGT
CGGAGTAACCCAGTAGTTGTTATCCTTCAT|GTTTACACGCATCCAACTAGAGTCATGATA
ATCGCCCCGATGTTCCTATCCGATTCCGGG|CGGGGTATGTACCGATAGTGGTGTTGTTCG
TCGTGATACTTCGAGACTGATACCCTTAAT|TTAAAGCCATACTAGAGTTGGCATCGAGAC
ACAGTAGGTCATTTCCCCACGCTGCGACCG|GATGCACCAGAACTTGTGGACCTGTCTGGA
GTCGACACGCATATCAACCTGCGTGCACAG|TTATTTAACTACCTCGGGTGGCGCAGTGGT
GGAATGAGTTTCACAGGATGTGGCCTATGC|CAGAAGGAGAGACTGATACCCTTAATTGCA
AGAGGATTATTTAACTACCTCGGGTGGCGC|GTGCCAGCTCGGCCTATTCTATACTAGGTG
GAATAGAGGAATGAGTTTCACAGGATGTGG|TTAATTGCAGAAGGAGAGACTGATACCCTT
GACGGTCTAGTCGAGACTGATACCCTTAAT|AGTCTCCTTAACTCTTAAGATACAATACGG
AGTCTCCTTAACTCTTAAGATACAATACGG|GAGACTGATACCCTTAATTGCAGAAGGACG
ACCCTTAATTGCAGAAGGATGTCTGTGAAT|ACAATACGGTCTCGAGACTGATACCCTTAA
CTTAATTGCAGAAGGACGGAGTAACCCAGT|CAAAGATGCTTGGCCTGTTTACACGCATCC
TAGAGTCATGATATCTCGACCGCGATCGCC|ATGGGCGCTCCGTATGGCCCAGCACGGGGT
CCTCTCGAGACTGATACCCTTAATTGCAGA|CTCCCAAATCGAGACTGATACCCTTAATTG
TAGCAGTCGCCATCAAGCACTTCCGGATCA|CCCACGCTGCGACCGAAGATTGATAGTGTA
CTGATACCCTTAATTGCAGAAGGAGAGACT|GTGATACTTCGAGACTGATACCCTTAATTG
GAGTTTCACAGGATGTGGCCTATGCGTGTT|GGAGAGACTGATACCCTTAATTGCAGAAGG
CAAGTTGTCCAATGCTAGTAAGAGGATTAT|TAATTGCAGAAGGAACTATGGTGCCAGCTC
CTCAGGCAGCTGACGTTAAAGAGGCTTCGC|AATAGACAAGTTGTCCAATGCTAGTAAGAG
ATCAAGCACTTCCGGATCAGCGTCTCAGGC|ACCGAAGATTGATAGTGTACATTAATAGAC
CTGGGGGTCATACGACCCAATCAGAGCCGA|ATACCCTTAATTGCAGAAGGACCCTTAATT
TTGCAGAAGGAGAGACTGATACCCTTAATT|ACTGATACCCTTAATTGCAGAAGGATGTCC
AGACTGATACCCTTAATTGCAGAAGGAACC|ATCGAGACTGATACCCTTAATTGCAGAAGG
CTGATACCCTTAATTGCAGAAGGACAACCC|TTCCTATCCGATTCCGGGTGGTACTCGCAC
TCTTAAGATACAATACGGTCTCGAGACTGA|CTTAATTGCAGAAGGACGGAGTAACCCAGT
GATTTTTGGGCCGGGGCTAGCAAAGATGCT|CCTGGATGTGGGTTTATTAGTCATTGCGGC
AGTGTACATTAATAGACAAGTTGTCCAATG|TCGAGACTGATACCCTTAATTGCAGAAGGA
TGTCGAAAGTACCATTCGTGGATGCACCAG|TTTAGAGCCTCGGTATCCTCTCGAGACTGA
CGAAGATTGATAGTGTACATTAATAGACAA|GATACAAGTCGTCGAGACTGATACCCTTAA
AATAGCACCGACTCTAGTCTCCTTAACTCT|TTGCAGAAGGATATCGAGACTGATACCCTT
CGGGTGGCGCAGTGGTGTCGAAAGTACCAT|ATACTAGGTGGAAGCTTTAGAGCCTCGGTA
TCGCACCTATCTCCCAAATCGAGACTGATA|ATAGAAAAAGTCCGTCGTATGTTCGAGACT
AGTTGTCCAATGCTAGTAAGAGGATTATTT|ATTGCAGAAGGAACTATGGTGCCAGCTCGG
GTCGAGACTGATACCCTTAATTGCAGAAGG|CGAGACTGATACCCTTAATTGCAGAAGGAG
TCGAGACTGATACCCTTAATTGCAGAAGGA|GTAACCCAGTAGTTGTTATCCTTCATAGGG
ACCCAGTAGTTGTTATCCTTCATAGGGAAA|CGCATCCAACTAGAGTCATGATATCTCGAC
CAGAAGGATGTCCTGGGGGTCATACGACCC|ATATCGAGACTGATACCCTTAATTGCAGAA
GAGACTGATACCCTTAATTGCAGAAGGAGA|AACCCAGTAGTTGTTATCCTTCATAGGGAA
TAGTCTCCTTAACTCTTAAGATACAATACG|CGAGACTGATACCCTTAATTGCAGAAGGAC
CTGATACCCTTAATTGCAGAAGGAACCCGT|GAGACTGATACCCTTAATTGCAGAAGGAGA
CGTATGTTCGAGACTGATACCCTTAATTGC|CCATTCCCCGACGGTCTAGTCGAGACTGAT
AGAAGGAGACGCGTTCGTGATACTTCGAGA|TTGCAGAAGGAAATTTAAAGCCATACTAGA
TCCGGATCAGCGTCTCAGGCAGCTGACGTT|GATAGTGTACATTAATAGACAAGTTGTCCA
CCAATCAGAGCCGAGATAGAAAAAGTCCGT|AAGGACCCTTAATTGCAGAAGGAATCGTGA
TAACTACCTCGGGTGGCGCAGTGGTGTCGA|GCCTATTCTATACTAGGTGGAAGCTTTAGA
ATCGAGACTGATACCCTTAATTGCAGAAGG|TATGTTCGAGACTGATACCCTTAATTGCAG
ACAGCGTCTTGTTCAGTAGGTGGACAGTAG|TGGTGTCGAAAGTACCATTCGTGGATGCAC
TACCCTTAATTGCAGAAGGATGTCCTGGGG|GCATCGAGACTGATATCGAGACTGATACCC
AGGTGGACAGTAGGTCATTTCCCCACGCTG|TTCGTGGATGCACCAGAACTTGTGGACCTG
GAGTAACCCAGTAGTTGTTATCCTTCATAG|TTACACGCATCCAACTAGAGTCATGATATC
ATCGAGACTGATACCCTTAATTGCAGAAGG|CCCGATGTTCCTATCCGATTCCGGGTGGTA
TACTAGGTGGAAGCTTTAGAGCCTCGGTAT|ACAAGATGAGCGCCGCCCGTTCGCACCTAT
GTCGTCGAGACTGATACCCTTAATTGCAGA|TCTCGAGACTGATACCCTTAATTGCAGAAG
AGACAAGATGAGCGCCGCCCGTTCGCACCT|ATACGACCCAATCAGAGCCGAGATAGAAAA
CCAGTAGTTGTTATCCTTCATAGGGAAAGT|CATCCAACTAGAGTCATGATATCTCGACCG
CCCCCAATCGTGATGATTTTTGGGCCGGGG|CACCTACGTGACACCCTGGATGTGGGTTTA
TGCCAGCTCGGCCTATTCTATACTAGGTGG|ACCCTTAATTGCAGAAGGAGACAAGATGAG
GCGCAGTGGTGTCGAAAGTACCATTCGTGG|GGTGGAAGCTTTAGAGCCTCGGTATCCTCT
TACTTCGAGACTGATACCCTTAATTGCAGA|CCATACTAGAGTTGGCATCGAGACTGATAT
ACTGATACCCTTAATTGCAGAAGGAAATTT|GGTCTAGTCGAGACTGATACCCTTAATTGC
AAGTTGTCCAATGCTAGTAAGAGGATTATT|AATTGCAGAAGGAACTATGGTGCCAGCTCG
AGGATGTGGCCTATGCGTGTTAGGAGAGCC|GATACCCTTAATTGCAGAAGGAATCGCCTC
AAGGAGACAAGATGAGCGCCGCCCGTTCGC|GGTCATACGACCCAATCAGAGCCGAGATAG
GGAAAGTCTAAAAAATCGAGACTGATACCC|TCGACCGCGATCGCCCCGATGTTCCTATCC
AATTGCAGAAGGAATCGTGACCATTCCCCG|CGGCCTACTAAGTAAATAGCACCGACTCTA
GAGCCGAGATAGAAAAAGTCCGTCGTATGT|CTTAATTGCAGAAGGAATCGTGACCATTCC
ATACCCTTAATTGCAGAAGGACGGAGTAAC|GCTAGCAAAGATGCTTGGCCTGTTTACACG
GAGGCATAGCAGTCGCCATCAAGCACTTCC|CATTTCCCCACGCTGCGACCGAAGATTGAT
AGGAGAGACTGATACCCTTAATTGCAGAAG|CCCTTAATTGCAGAAGGATGTCCTGGGGGT
TGATACCCTTAATTGCAGAAGGATATCGAG|GACAACCCCCAATCGTGATGATTTTTGGGC
GAAGGAACCCGTCTCGAGACTGATACCCTT|TGCAGAAGGAGACGCGTTCGTGATACTTCG
AATTGCAGAAGGAACTATGGTGCCAGCTCG|TTGCAGAAGGAGAGACTGATACCCTTAATT
CGCCCCGATGTTCCTATCCGATTCCGGGTG|GGGTATGTACCGATAGTGGTGTTGTTCGAG
CCCTTAATTGCAGAAGGACGGAGTAACCCA|AGCAAAGATGCTTGGCCTGTTTACACGCAT
ACCCTTAATTGCAGAAGGAATCGTGACCAT|GCCCCCCGGCCTACTAAGTAAATAGCACCG
AGAAAAAGTCCGTCGTATGTTCGAGACTGA|GAAGGAATCGTGACCATTCCCCGACGGTCT
ATCGAGACTGATACCCTTAATTGCAGAAGG|TTGGGCCGGGGCTAGCAAAGATGCTTGGCC
GAAGCTTTAGAGCCTCGGTATCCTCTCGAG|GCGCCGCCCGTTCGCACCTATCTCCCAAAT
TGTTTACACGCATCCAACTAGAGTCATGAT|ACGATAGGGTTGTCCCTCATGGGCGCTCCG
CCCTCAGAGCGGTAGGCATAGATCAATCTT|CACAGCGTCTTGTTCAGTAGGTGGACAGTA
CCATCAAGCACTTCCGGATCAGCGTCTCAG|CGACCGAAGATTGATAGTGTACATTAATAG
GTTATCCTTCATAGGGAAAGTCTAAAAAAT|AGAGTCATGATATCTCGACCGCGATCGCCC
CTGATACCCTTAATTGCAGAAGGAACTATG|GATACCCTTAATTGCAGAAGGAGAGACTGA
CTCTAGTCTCCTTAACTCTTAAGATACAAT|TATCGAGACTGATACCCTTAATTGCAGAAG
AATTGCAGAAGGACAACCCCCAATCGTGAT|TTCCGGGTGGTACTCGCACCTACGTGACAC
TTGGCCTGTTTACACGCATCCAACTAGAGT|CCCTCTACGATAGGGTTGTCCCTCATGGGC
AGACTGATACCCTTAATTGCAGAAGGATGT|AGAGTTGGCATCGAGACTGATATCGAGACT
AAGATTGATAGTGTACATTAATAGACAAGT|TACAAGTCGTCGAGACTGATACCCTTAATT
TGCAGAAGGATATCGAGACTGATACCCTTA|CGTGATGATTTTTGGGCCGGGGCTAGCAAA
TTGCAGAAGGACGGAGTAACCCAGTAGTTG|ATGCTTGGCCTGTTTACACGCATCCAACTA
ATGATATCTCGACCGCGATCGCCCCGATGT|CTCCGTATGGCCCAGCACGGGGTATGTACC
ACTGATACCCTTAATTGCAGAAGGATGTCT|TAAGATACAATACGGTCTCGAGACTGATAC
TTCATAGGGAAAGTCTAAAAAATCGAGACT|TGATATCTCGACCGCGATCGCCCCGATGTT
TTGATAGTGTACATTAATAGACAAGTTGTC|AGTCGTCGAGACTGATACCCTTAATTGCAG
GTGGACAGTAGGTCATTTCCCCACGCTGCG|CGTGGATGCACCAGAACTTGTGGACCTGTC
CGTCTCAGGCAGCTGACGTTAAAGAGGCTT|ATTAATAGACAAGTTGTCCAATGCTAGTAA
TTCGAGACTGATACCCTTAATTGCAGAAGG|CCCGACGGTCTAGTCGAGACTGATACCCTT
CGAGACTGATACCCTTAATTGCAGAAGGAT|CAGAAGGACAACCCCCAATCGTGATGATTT
GATGTGGCCTATGCGTGTTAGGAGAGCCCC|TACCCTTAATTGCAGAAGGAATCGCCTCGA
GCACCAGAACTTGTGGACCTGTCTGGATAC|AGACTGATACCCTTAATTGCAGAAGGAACC
TGATACCCTTAATTGCAGAAGGAGACGCGT|AGACTGATACCCTTAATTGCAGAAGGAAAT
GTCTCCTTAACTCTTAAGATACAATACGGT|AGACTGATACCCTTAATTGCAGAAGGACGG
GACTGATACCCTTAATTGCAGAAGGAAATT|CGGTCTAGTCGAGACTGATACCCTTAATTG
TCGCCTCGAGACTGATACCCTTAATTGCAG|TAATTGCAGAAGGACAACCCCCAATCGTGA
TGCAGAAGGACAACCCCCAATCGTGATGAT|CGGGTGGTACTCGCACCTACGTGACACCCT
AGACTGATACCCTTAATTGCAGAAGGACGG|GCCGGGGCTAGCAAAGATGCTTGGCCTGTT
TTGGCATCGAGACTGATATCGAGACTGATA|AATAGAGGAATGAGTTTCACAGGATGTGGC
TGATACCCTTAATTGCAGAAGGAGAGACTG|TGATACTTCGAGACTGATACCCTTAATTGC
TGGTGTCGAAAGTACCATTCGTGGATGCAC|AGCTTTAGAGCCTCGGTATCCTCTCGAGAC
CCCACGCTGCGACCGAAGATTGATAGTGTA|GTGGACCTGTCTGGATACAAGTCGTCGAGA
ACATTAATAGACAAGTTGTCCAATGCTAGT|ACTGATACCCTTAATTGCAGAAGGAACTAT
TAGACAAGTTGTCCAATGCTAGTAAGAGGA|CCCTTAATTGCAGAAGGAACTATGGTGCCA
ATTGCAGAAGGACCCTTAATTGCAGAAGGA|GTGTTAGGAGAGCCCCCCGGCCTACTAAGT
GTTTACACGCATCCAACTAGAGTCATGATA|CGATAGGGTTGTCCCTCATGGGCGCTCCGT
GAAGGACGGAGTAACCCAGTAGTTGTTATC|TGGCCTGTTTACACGCATCCAACTAGAGTC
AGTAGGTCATTTCCCCACGCTGCGACCGAA|TGCACCAGAACTTGTGGACCTGTCTGGATA
AGGAATCGCCTCGAGACTGATACCCTTAAT|ACCCTTAATTGCAGAAGGACAACCCCCAAT
CGAGGCATAGCAGTCGCCATCAAGCACTTC|TCATTTCCCCACGCTGCGACCGAAGATTGA
TGTCCAATGCTAGTAAGAGGATTATTTAAC|GCAGAAGGAACTATGGTGCCAGCTCGGCCT
CAGAGCGGTAGGCATAGATCAATCTTTCCG|GCGTCTTGTTCAGTAGGTGGACAGTAGGTC
GGTGGAAGCTTTAGAGCCTCGGTATCCTCT|ATGAGCGCCGCCCGTTCGCACCTATCTCCC
GACACGCATATCAACCTGCGTGCACAGCGT|TTTAACTACCTCGGGTGGCGCAGTGGTGTC
CACTTCCGGATCAGCGTCTCAGGCAGCTGA|GATTGATAGTGTACATTAATAGACAAGTTG
CTAGTCTCCTTAACTCTTAAGATACAATAC|TCGAGACTGATACCCTTAATTGCAGAAGGA
CAGCTCGGCCTATTCTATACTAGGTGGAAG|CTTAATTGCAGAAGGAGACAAGATGAGCGC
GCACCTATCTCCCAAATCGAGACTGATACC|AGAAAAAGTCCGTCGTATGTTCGAGACTGA
CACGCATATCAACCTGCGTGCACAGCGTCT|TAACTACCTCGGGTGGCGCAGTGGTGTCGA
CTTTAGAGCCTCGGTATCCTCTCGAGACTG|CGCCCGTTCGCACCTATCTCCCAAATCGAG
ACGCATATCAACCTGCGTGCACAGCGTCTT|AACTACCTCGGGTGGCGCAGTGGTGTCGAA
TTGCAGAAGGAGACAAGATGAGCGCCGCCC|CCTGGGGGTCATACGACCCAATCAGAGCCG
ACCCTTAATTGCAGAAGGACAACCCCCAAT|ATCCGATTCCGGGTGGTACTCGCACCTACG
TCCGAGGCATAGCAGTCGCCATCAAGCACT|GGTCATTTCCCCACGCTGCGACCGAAGATT
CCCGGCCTACTAAGTAAATAGCACCGACTC|AGACTGATACCCTTAATTGCAGAAGGATAT
GTGGCCTATGCGTGTTAGGAGAGCCCCCCG|CCTTAATTGCAGAAGGAATCGCCTCGAGAC
AGGCAGCTGACGTTAAAGAGGCTTCGCAGG|AGACAAGTTGTCCAATGCTAGTAAGAGGAT
AGGAGACGCGTTCGTGATACTTCGAGACTG|CAGAAGGAAATTTAAAGCCATACTAGAGTT
ACCCTTAATTGCAGAAGGAGACGCGTTCGT|TGATACCCTTAATTGCAGAAGGAAATTTAA
AGGAGAGACTGATACCCTTAATTGCAGAAG|AGGGAAAGTCTAAAAAATCGAGACTGATAC
GGCATAGCAGTCGCCATCAAGCACTTCCGG|TTTCCCCACGCTGCGACCGAAGATTGATAG
CTAAGTAAATAGCACCGACTCTAGTCTCCT|CCCTTAATTGCAGAAGGATATCGAGACTGA
TAATTGCAGAAGGACCCTTAATTGCAGAAG|GCGTGTTAGGAGAGCCCCCCGGCCTACTAA
AGAGACTGATACCCTTAATTGCAGAAGGAA|GAAAGTCTAAAAAATCGAGACTGATACCCT
GTTAAAGAGGCTTCGCAGGTCGACACGCAT|CCAATGCTAGTAAGAGGATTATTTAACTAC
CGTTAAAGAGGCTTCGCAGGTCGACACGCA|TCCAATGCTAGTAAGAGGATTATTTAACTA
AAGTACCATTCGTGGATGCACCAGAACTTG|GCCTCGGTATCCTCTCGAGACTGATACCCT
GGACCCTTAATTGCAGAAGGAATCGTGACC|GAGCCCCCCGGCCTACTAAGTAAATAGCAC
AATTGCAGAAGGATATCGAGACTGATACCC|AATCGTGATGATTTTTGGGCCGGGGCTAGC
GACTGATACCCTTAATTGCAGAAGGACGGA|CCGGGGCTAGCAAAGATGCTTGGCCTGTTT
TAGTTGTTATCCTTCATAGGGAAAGTCTAA|CAACTAGAGTCATGATATCTCGACCGCGAT
CTGACGTTAAAGAGGCTTCGCAGGTCGACA|GTTGTCCAATGCTAGTAAGAGGATTATTTA
TACCATTCGTGGATGCACCAGAACTTGTGG|TCGGTATCCTCTCGAGACTGATACCCTTAA
CTTCGCAGGTCGACACGCATATCAACCTGC|TAAGAGGATTATTTAACTACCTCGGGTGGC
GTCCAATGCTAGTAAGAGGATTATTTAACT|CAGAAGGAACTATGGTGCCAGCTCGGCCTA
TAGAGCCTCGGTATCCTCTCGAGACTGATA|CCGTTCGCACCTATCTCCCAAATCGAGACT
GGCAGCTGACGTTAAAGAGGCTTCGCAGGT|GACAAGTTGTCCAATGCTAGTAAGAGGATT
ACCTGTCTGGATACAAGTCGTCGAGACTGA|TTGCAGAAGGAACCCGTCTCGAGACTGATA
GCAGAAGGAGAGACTGATACCCTTAATTGC|TGATACCCTTAATTGCAGAAGGATGTCCTG
CTTCCGGATCAGCGTCTCAGGCAGCTGACG|TTGATAGTGTACATTAATAGACAAGTTGTC
CGTGACCATTCCCCGACGGTCTAGTCGAGA|ATAGCACCGACTCTAGTCTCCTTAACTCTT
AATCTTTCCGAGGCATAGCAGTCGCCATCA|ACAGTAGGTCATTTCCCCACGCTGCGACCG
TCGAGACTGATACCCTTAATTGCAGAAGGA|CCGACGGTCTAGTCGAGACTGATACCCTTA
CCTTAATTGCAGAAGGATGTCTGTGAATAG|AATACGGTCTCGAGACTGATACCCTTAATT
GCCATCAAGCACTTCCGGATCAGCGTCTCA|GCGACCGAAGATTGATAGTGTACATTAATA
AGAGGAATGAGTTTCACAGGATGTGGCCTA|TTGCAGAAGGAGAGACTGATACCCTTAATT
ATACCCTTAATTGCAGAAGGAGACAAGATG|AGAAGGATGTCCTGGGGGTCATACGACCCA
ATATCTCGACCGCGATCGCCCCGATGTTCC|CGTATGGCCCAGCACGGGGTATGTACCGAT
GATGAGCGCCGCCCGTTCGCACCTATCTCC|CCCAATCAGAGCCGAGATAGAAAAAGTCCG
GACGTTAAAGAGGCTTCGCAGGTCGACACG|TGTCCAATGCTAGTAAGAGGATTATTTAAC
TCGAGACTGATACCCTTAATTGCAGAAGGA|TGGGCCGGGGCTAGCAAAGATGCTTGGCCT
ACTGATACCCTTAATTGCAGAAGGACAACC|GTTCCTATCCGATTCCGGGTGGTACTCGCA
ATATCGAGACTGATACCCTTAATTGCAGAA|TTCACAGGATGTGGCCTATGCGTGTTAGGA
CGCCGCCCGTTCGCACCTATCTCCCAAATC|CAGAGCCGAGATAGAAAAAGTCCGTCGTAT
CCTTAATTGCAGAAGGACGGAGTAACCCAG|GCAAAGATGCTTGGCCTGTTTACACGCATC
CTTAAGATACAATACGGTCTCGAGACTGAT|TTAATTGCAGAAGGACGGAGTAACCCAGTA
AGACTGATACCCTTAATTGCAGAAGGACAA|ATGTTCCTATCCGATTCCGGGTGGTACTCG
TTAATTGCAGAAGGACCCTTAATTGCAGAA|TGCGTGTTAGGAGAGCCCCCCGGCCTACTA
TAGCAAAGATGCTTGGCCTGTTTACACGCA|TAGTCATTGCGGCCCTCTACGATAGGGTTG
GTAGGTCATTTCCCCACGCTGCGACCGAAG|GCACCAGAACTTGTGGACCTGTCTGGATAC
TGTTCCTATCCGATTCCGGGTGGTACTCGC|ACCGATAGTGGTGTTGTTCGAGCAGTCCGC
GAGACTGATACCCTTAATTGCAGAAGGAGA|GTTCGAGACTGATACCCTTAATTGCAGAAG
GACTGATACCCTTAATTGCAGAAGGAATCG|AGTCTAAAAAATCGAGACTGATACCCTTAA
AAAGCCATACTAGAGTTGGCATCGAGACTG|AGAAGGATGTCTGTGAATAGAGGAATGAGT
TCTATACTAGGTGGAAGCTTTAGAGCCTCG|GGAGACAAGATGAGCGCCGCCCGTTCGCAC
GGTGTCGAAAGTACCATTCGTGGATGCACC|GCTTTAGAGCCTCGGTATCCTCTCGAGACT
TTCCCCGACGGTCTAGTCGAGACTGATACC|GACTCTAGTCTCCTTAACTCTTAAGATACA
GACTGATACCCTTAATTGCAGAAGGAGAGA|TCGTGATACTTCGAGACTGATACCCTTAAT
CCCAGTAGTTGTTATCCTTCATAGGGAAAG|GCATCCAACTAGAGTCATGATATCTCGACC
CAGCTGACGTTAAAGAGGCTTCGCAGGTCG|CAAGTTGTCCAATGCTAGTAAGAGGATTAT
AAGATGCTTGGCCTGTTTACACGCATCCAA|ATTGCGGCCCTCTACGATAGGGTTGTCCCT
GGAGAGACTGATACCCTTAATTGCAGAAGG|CCTTAATTGCAGAAGGATGTCCTGGGGGTC
TCGTGACCATTCCCCGACGGTCTAGTCGAG|AATAGCACCGACTCTAGTCTCCTTAACTCT
TACGGTCTCGAGACTGATACCCTTAATTGC|GGACGGAGTAACCCAGTAGTTGTTATCCTT
CAATCTTTCCGAGGCATAGCAGTCGCCATC|GACAGTAGGTCATTTCCCCACGCTGCGACC
CCCGACGGTCTAGTCGAGACTGATACCCTT|TCTAGTCTCCTTAACTCTTAAGATACAATA
GAAGGATGTCCTGGGGGTCATACGACCCAA|ATCGAGACTGATACCCTTAATTGCAGAAGG
CTTGGCCTGTTTACACGCATCCAACTAGAG|GCCCTCTACGATAGGGTTGTCCCTCATGGG
GTCGTATGTTCGAGACTGATACCCTTAATT|GACCATTCCCCGACGGTCTAGTCGAGACTG
ACCCTTAATTGCAGAAGGAATCGCCTCGAG|AAAATCGAGACTGATACCCTTAATTGCAGA
TGCGACCGAAGATTGATAGTGTACATTAAT|TGTCTGGATACAAGTCGTCGAGACTGATAC
TTAACTCTTAAGATACAATACGGTCTCGAG|ATACCCTTAATTGCAGAAGGACGGAGTAAC
CCGAAGATTGATAGTGTACATTAATAGACA|GGATACAAGTCGTCGAGACTGATACCCTTA
CATCGAGACTGATATCGAGACTGATACCCT|GAGGAATGAGTTTCACAGGATGTGGCCTAT
AGGACAACCCCCAATCGTGATGATTTTTGG|GTACTCGCACCTACGTGACACCCTGGATGT
CAGCGTCTTGTTCAGTAGGTGGACAGTAGG|GGTGTCGAAAGTACCATTCGTGGATGCACC
GGGGCTAGCAAAGATGCTTGGCCTGTTTAC|TTTATTAGTCATTGCGGCCCTCTACGATAG
CTTAATTGCAGAAGGAGACGCGTTCGTGAT|TACCCTTAATTGCAGAAGGAAATTTAAAGC
CTATACTAGGTGGAAGCTTTAGAGCCTCGG|GAGACAAGATGAGCGCCGCCCGTTCGCACC
ACTGATACCCTTAATTGCAGAAGGAACTAT|TGATACCCTTAATTGCAGAAGGAGAGACTG
AATTGCAGAAGGAATCGCCTCGAGACTGAT|GAGACTGATACCCTTAATTGCAGAAGGACA
AAGGACGGAGTAACCCAGTAGTTGTTATCC|GGCCTGTTTACACGCATCCAACTAGAGTCA
AAAAAATCGAGACTGATACCCTTAATTGCA|ATCGCCCCGATGTTCCTATCCGATTCCGGG
AGACTGATACCCTTAATTGCAGAAGGAACT|ACTGATACCCTTAATTGCAGAAGGAGAGAC
AAAGTACCATTCGTGGATGCACCAGAACTT|AGCCTCGGTATCCTCTCGAGACTGATACCC
TTAATAGACAAGTTGTCCAATGCTAGTAAG|GATACCCTTAATTGCAGAAGGAACTATGGT
CCAATGCTAGTAAGAGGATTATTTAACTAC|GAAGGAACTATGGTGCCAGCTCGGCCTATT
TACCTCGGGTGGCGCAGTGGTGTCGAAAGT|ATTCTATACTAGGTGGAAGCTTTAGAGCCT
AGTAACCCAGTAGTTGTTATCCTTCATAGG|TACACGCATCCAACTAGAGTCATGATATCT
ATAGACAAGTTGTCCAATGCTAGTAAGAGG|ACCCTTAATTGCAGAAGGAACTATGGTGCC
GACTGATACCCTTAATTGCAGAAGGATATC|AAGGACAACCCCCAATCGTGATGATTTTTG
AGAAGGAGAGACTGATACCCTTAATTGCAG|CATAGGGAAAGTCTAAAAAATCGAGACTGA
TCAACCTGCGTGCACAGCGTCTTGTTCAGT|TCGGGTGGCGCAGTGGTGTCGAAAGTACCA
CTCAGAGCGGTAGGCATAGATCAATCTTTC|CAGCGTCTTGTTCAGTAGGTGGACAGTAGG
TGATACCCTTAATTGCAGAAGGAATCGCCT|CTAAAAAATCGAGACTGATACCCTTAATTG
TTCGCAGGTCGACACGCATATCAACCTGCG|AAGAGGATTATTTAACTACCTCGGGTGGCG
CCGAGGCATAGCAGTCGCCATCAAGCACTT|GTCATTTCCCCACGCTGCGACCGAAGATTG
ACAAGATGAGCGCCGCCCGTTCGCACCTAT|ACGACCCAATCAGAGCCGAGATAGAAAAAG
CCGTTCGCACCTATCTCCCAAATCGAGACT|CGAGATAGAAAAAGTCCGTCGTATGTTCGA
GATACAAGTCGTCGAGACTGATACCCTTAA|GAACCCGTCTCGAGACTGATACCCTTAATT
TAATTGCAGAAGGAGAGACTGATACCCTTA|TATCCTTCATAGGGAAAGTCTAAAAAATCG
AGAGCCTCGGTATCCTCTCGAGACTGATAC|CGTTCGCACCTATCTCCCAAATCGAGACTG
GAGACTGATACCCTTAATTGCAGAAGGATG|TAGAGTTGGCATCGAGACTGATATCGAGAC
ACCGACTCTAGTCTCCTTAACTCTTAAGAT|AAGGATATCGAGACTGATACCCTTAATTGC
AGACTGATATCGAGACTGATACCCTTAATT|ATGAGTTTCACAGGATGTGGCCTATGCGTG
GTCTGTGAATAGAGGAATGAGTTTCACAGG|ATACCCTTAATTGCAGAAGGAGAGACTGAT
AACTCTTAAGATACAATACGGTCTCGAGAC|ACCCTTAATTGCAGAAGGACGGAGTAACCC
ATGGTGCCAGCTCGGCCTATTCTATACTAG|TGATACCCTTAATTGCAGAAGGAGACAAGA
TGGGCCGGGGCTAGCAAAGATGCTTGGCCT|TGTGGGTTTATTAGTCATTGCGGCCCTCTA
GTCTCAGGCAGCTGACGTTAAAGAGGCTTC|TTAATAGACAAGTTGTCCAATGCTAGTAAG
ATTAATAGACAAGTTGTCCAATGCTAGTAA|TGATACCCTTAATTGCAGAAGGAACTATGG
GCCGCCCGTTCGCACCTATCTCCCAAATCG|AGAGCCGAGATAGAAAAAGTCCGTCGTATG
ACTAGAGTCATGATATCTCGACCGCGATCG|TCATGGGCGCTCCGTATGGCCCAGCACGGG
AAGAGGCTTCGCAGGTCGACACGCATATCA|TGCTAGTAAGAGGATTATTTAACTACCTCG
GATATCGAGACTGATACCCTTAATTGCAGA|TTTTTGGGCCGGGGCTAGCAAAGATGCTTG
GATAGAAAAAGTCCGTCGTATGTTCGAGAC|GCAGAAGGAATCGTGACCATTCCCCGACGG
AGACAAGTTGTCCAATGCTAGTAAGAGGAT|CCTTAATTGCAGAAGGAACTATGGTGCCAG
CGGATCAGCGTCTCAGGCAGCTGACGTTAA|TAGTGTACATTAATAGACAAGTTGTCCAAT
GATGTTCCTATCCGATTCCGGGTGGTACTC|GTACCGATAGTGGTGTTGTTCGAGCAGTCC
GAAAGTCTAAAAAATCGAGACTGATACCCT|CGACCGCGATCGCCCCGATGTTCCTATCCG
AGAAGGAATCGTGACCATTCCCCGACGGTC|ACTAAGTAAATAGCACCGACTCTAGTCTCC
GAGCCCCCCGGCCTACTAAGTAAATAGCAC|GCCTCGAGACTGATACCCTTAATTGCAGAA
AGACTGATACCCTTAATTGCAGAAGGAAAT|ACGGTCTAGTCGAGACTGATACCCTTAATT
TGTTCGAGACTGATACCCTTAATTGCAGAA|TCCCCGACGGTCTAGTCGAGACTGATACCC
CCATTCCCCGACGGTCTAGTCGAGACTGAT|ACCGACTCTAGTCTCCTTAACTCTTAAGAT
ACTCTAGTCTCCTTAACTCTTAAGATACAA|ATATCGAGACTGATACCCTTAATTGCAGAA
CAGAAGGACGGAGTAACCCAGTAGTTGTTA|CTTGGCCTGTTTACACGCATCCAACTAGAG
GGCCTATGCGTGTTAGGAGAGCCCCCCGGC|TTAATTGCAGAAGGAATCGCCTCGAGACTG
CACAGCGTCTTGTTCAGTAGGTGGACAGTA|GTGGTGTCGAAAGTACCATTCGTGGATGCA
CAGAAGGAATCGCCTCGAGACTGATACCCT|TGATACCCTTAATTGCAGAAGGACAACCCC
CCGCGATCGCCCCGATGTTCCTATCCGATT|CAGCACGGGGTATGTACCGATAGTGGTGTT
ATTGATAGTGTACATTAATAGACAAGTTGT|AAGTCGTCGAGACTGATACCCTTAATTGCA
CTGATACCCTTAATTGCAGAAGGAGACAAG|TGCAGAAGGATGTCCTGGGGGTCATACGAC
AAGGAACTATGGTGCCAGCTCGGCCTATTC|GGAGAGACTGATACCCTTAATTGCAGAAGG
CACCTATCTCCCAAATCGAGACTGATACCC|GAAAAAGTCCGTCGTATGTTCGAGACTGAT
AGCTTTAGAGCCTCGGTATCCTCTCGAGAC|GCCGCCCGTTCGCACCTATCTCCCAAATCG
CCATACTAGAGTTGGCATCGAGACTGATAT|GGATGTCTGTGAATAGAGGAATGAGTTTCA
ATTGCAGAAGGAACCCGTCTCGAGACTGAT|CTTAATTGCAGAAGGAGACGCGTTCGTGAT
CCCTTAATTGCAGAAGGATGTCTGTGAATA|CAATACGGTCTCGAGACTGATACCCTTAAT
AAGGATGTCTGTGAATAGAGGAATGAGTTT|AGACTGATACCCTTAATTGCAGAAGGAGAG
CACCAGAACTTGTGGACCTGTCTGGATACA|GACTGATACCCTTAATTGCAGAAGGAACCC
AGCGTCTCAGGCAGCTGACGTTAAAGAGGC|ACATTAATAGACAAGTTGTCCAATGCTAGT
GCCATACTAGAGTTGGCATCGAGACTGATA|AGGATGTCTGTGAATAGAGGAATGAGTTTC
CATAGGGAAAGTCTAAAAAATCGAGACTGA|ATATCTCGACCGCGATCGCCCCGATGTTCC
TGATACCCTTAATTGCAGAAGGATGTCCTG|TTGGCATCGAGACTGATATCGAGACTGATA
GAAGGAGACGCGTTCGTGATACTTCGAGAC|TGCAGAAGGAAATTTAAAGCCATACTAGAG
TGCAGAAGGAGAGACTGATACCCTTAATTG|CTGATACCCTTAATTGCAGAAGGATGTCCT
TGGCCTATGCGTGTTAGGAGAGCCCCCCGG|CTTAATTGCAGAAGGAATCGCCTCGAGACT
ATGCTAGTAAGAGGATTATTTAACTACCTC|GGAACTATGGTGCCAGCTCGGCCTATTCTA
GCAGAAGGACCCTTAATTGCAGAAGGAATC|TTAGGAGAGCCCCCCGGCCTACTAAGTAAA
AATTGCAGAAGGAACCCGTCTCGAGACTGA|CCTTAATTGCAGAAGGAGACGCGTTCGTGA
CAACTAGAGTCATGATATCTCGACCGCGAT|CCTCATGGGCGCTCCGTATGGCCCAGCACG
CGAGACTGATACCCTTAATTGCAGAAGGAG|TGTTCGAGACTGATACCCTTAATTGCAGAA
GTAAGAGGATTATTTAACTACCTCGGGTGG|ATGGTGCCAGCTCGGCCTATTCTATACTAG
TACATTAATAGACAAGTTGTCCAATGCTAG|GACTGATACCCTTAATTGCAGAAGGAACTA
TGCAGAAGGAAATTTAAAGCCATACTAGAG|GATACCCTTAATTGCAGAAGGATGTCTGTG
AGGATGTCCTGGGGGTCATACGACCCAATC|CGAGACTGATACCCTTAATTGCAGAAGGAC
TAAAAAATCGAGACTGATACCCTTAATTGC|GATCGCCCCGATGTTCCTATCCGATTCCGG
CGAGACTGATACCCTTAATTGCAGAAGGAA|AAATCGAGACTGATACCCTTAATTGCAGAA
ACTGATACCCTTAATTGCAGAAGGAGACAA|TTGCAGAAGGATGTCCTGGGGGTCATACGA
TAGAGGAATGAGTTTCACAGGATGTGGCCT|ATTGCAGAAGGAGAGACTGATACCCTTAAT
CTAGTCGAGACTGATACCCTTAATTGCAGA|CTTAACTCTTAAGATACAATACGGTCTCGA
CTGATACCCTTAATTGCAGAAGGAAATTTA|GTCTAGTCGAGACTGATACCCTTAATTGCA
GATACCCTTAATTGCAGAAGGAGAGACTGA|GTAGTTGTTATCCTTCATAGGGAAAGTCTA
CCGATGTTCCTATCCGATTCCGGGTGGTAC|ATGTACCGATAGTGGTGTTGTTCGAGCAGT
GCAGAAGGACGGAGTAACCCAGTAGTTGTT|GCTTGGCCTGTTTACACGCATCCAACTAGA
TTTTTGGGCCGGGGCTAGCAAAGATGCTTG|TGGATGTGGGTTTATTAGTCATTGCGGCCC
TTAATTGCAGAAGGATGTCTGTGAATAGAG|TACGGTCTCGAGACTGATACCCTTAATTGC
CAGTGGTGTCGAAAGTACCATTCGTGGATG|GGAAGCTTTAGAGCCTCGGTATCCTCTCGA
GGACCTGTCTGGATACAAGTCGTCGAGACT|AATTGCAGAAGGAACCCGTCTCGAGACTGA
TGGATGCACCAGAACTTGTGGACCTGTCTG|TCTCGAGACTGATACCCTTAATTGCAGAAG
CTTAATTGCAGAAGGAATCGCCTCGAGACT|ATCGAGACTGATACCCTTAATTGCAGAAGG
CATCAAGCACTTCCGGATCAGCGTCTCAGG|GACCGAAGATTGATAGTGTACATTAATAGA
ACACGCATCCAACTAGAGTCATGATATCTC|AGGGTTGTCCCTCATGGGCGCTCCGTATGG
CTCGGCCTATTCTATACTAGGTGGAAGCTT|AATTGCAGAAGGAGACAAGATGAGCGCCGC
CAGAAGGAATCGTGACCATTCCCCGACGGT|TACTAAGTAAATAGCACCGACTCTAGTCTC
CCTTAATTGCAGAAGGAACCCGTCTCGAGA|ATACCCTTAATTGCAGAAGGAGACGCGTTC
TGGCATCGAGACTGATATCGAGACTGATAC|ATAGAGGAATGAGTTTCACAGGATGTGGCC
TTCGTGGATGCACCAGAACTTGTGGACCTG|ATCCTCTCGAGACTGATACCCTTAATTGCA
TAATTGCAGAAGGAACTATGGTGCCAGCTC|ATTGCAGAAGGAGAGACTGATACCCTTAAT
TTGCAGAAGGAATCGCCTCGAGACTGATAC|GACTGATACCCTTAATTGCAGAAGGACAAC
ACGACCCAATCAGAGCCGAGATAGAAAAAG|TGCAGAAGGACCCTTAATTGCAGAAGGAAT
GACTGATACCCTTAATTGCAGAAGGATGTC|GAGTTGGCATCGAGACTGATATCGAGACTG
GAGCGGTAGGCATAGATCAATCTTTCCGAG|GTCTTGTTCAGTAGGTGGACAGTAGGTCAT
ACTCTTAAGATACAATACGGTCTCGAGACT|CCCTTAATTGCAGAAGGACGGAGTAACCCA
CCCTTAATTGCAGAAGGAGACGCGTTCGTG|GATACCCTTAATTGCAGAAGGAAATTTAAA
AGAGCGGTAGGCATAGATCAATCTTTCCGA|CGTCTTGTTCAGTAGGTGGACAGTAGGTCA
CGAGACTGATACCCTTAATTGCAGAAGGAA|AGACTGATACCCTTAATTGCAGAAGGAGAG
ATTGCAGAAGGAGACAAGATGAGCGCCGCC|TCCTGGGGGTCATACGACCCAATCAGAGCC
CAAGATGAGCGCCGCCCGTTCGCACCTATC|CGACCCAATCAGAGCCGAGATAGAAAAAGT
AGACTGATACCCTTAATTGCAGAAGGATAT|GAAGGACAACCCCCAATCGTGATGATTTTT
TGTCCTGGGGGTCATACGACCCAATCAGAG|ACTGATACCCTTAATTGCAGAAGGACCCTT
TCTCGAGACTGATACCCTTAATTGCAGAAG|GAGTAACCCAGTAGTTGTTATCCTTCATAG
CATAGATCAATCTTTCCGAGGCATAGCAGT|GTAGGTGGACAGTAGGTCATTTCCCCACGC
AATTGCAGAAGGACGGAGTAACCCAGTAGT|AGATGCTTGGCCTGTTTACACGCATCCAAC
GTTTCACAGGATGTGGCCTATGCGTGTTAG|AGAGACTGATACCCTTAATTGCAGAAGGAA
TTTAAAGCCATACTAGAGTTGGCATCGAGA|TGCAGAAGGATGTCTGTGAATAGAGGAATG
CTTAATTGCAGAAGGATATCGAGACTGATA|CCCAATCGTGATGATTTTTGGGCCGGGGCT
TCAGGCAGCTGACGTTAAAGAGGCTTCGCA|ATAGACAAGTTGTCCAATGCTAGTAAGAGG
GCCTGTTTACACGCATCCAACTAGAGTCAT|TCTACGATAGGGTTGTCCCTCATGGGCGCT
GTACCATTCGTGGATGCACCAGAACTTGTG|CTCGGTATCCTCTCGAGACTGATACCCTTA
ATGCTTGGCCTGTTTACACGCATCCAACTA|GCGGCCCTCTACGATAGGGTTGTCCCTCAT
TACCCTTAATTGCAGAAGGAGACAAGATGA|GAAGGATGTCCTGGGGGTCATACGACCCAA
GATCGCCCCGATGTTCCTATCCGATTCCGG|ACGGGGTATGTACCGATAGTGGTGTTGTTC
CTGATACCCTTAATTGCAGAAGGAGACGCG|GAGACTGATACCCTTAATTGCAGAAGGAAA
TCAATCTTTCCGAGGCATAGCAGTCGCCAT|GGACAGTAGGTCATTTCCCCACGCTGCGAC
CCAGCTCGGCCTATTCTATACTAGGTGGAA|CCTTAATTGCAGAAGGAGACAAGATGAGCG
GATACCCTTAATTGCAGAAGGACCCTTAAT|TGGCCTATGCGTGTTAGGAGAGCCCCCCGG
TTAATTGCAGAAGGAGAGACTGATACCCTT|TTATCCTTCATAGGGAAAGTCTAAAAAATC
CGGCCTACTAAGTAAATAGCACCGACTCTA|ACTGATACCCTTAATTGCAGAAGGATATCG
GTGGAAGCTTTAGAGCCTCGGTATCCTCTC|TGAGCGCCGCCCGTTCGCACCTATCTCCCA
TGCAGAAGGATGTCCTGGGGGTCATACGAC|TGATATCGAGACTGATACCCTTAATTGCAG
TCCTTAACTCTTAAGATACAATACGGTCTC|CTGATACCCTTAATTGCAGAAGGACGGAGT
TCTAGTCGAGACTGATACCCTTAATTGCAG|CCTTAACTCTTAAGATACAATACGGTCTCG
GAGACAAGATGAGCGCCGCCCGTTCGCACC|CATACGACCCAATCAGAGCCGAGATAGAAA
ATAGAAAAAGTCCGTCGTATGTTCGAGACT|CAGAAGGAATCGTGACCATTCCCCGACGGT
AGCCTCGGTATCCTCTCGAGACTGATACCC|TTCGCACCTATCTCCCAAATCGAGACTGAT
AGATGAGCGCCGCCCGTTCGCACCTATCTC|ACCCAATCAGAGCCGAGATAGAAAAAGTCC
AGGAGACAAGATGAGCGCCGCCCGTTCGCA|GTCATACGACCCAATCAGAGCCGAGATAGA
TAATTGCAGAAGGAATCGCCTCGAGACTGA|CGAGACTGATACCCTTAATTGCAGAAGGAC
GTGGATGCACCAGAACTTGTGGACCTGTCT|CTCTCGAGACTGATACCCTTAATTGCAGAA
GGAAGCTTTAGAGCCTCGGTATCCTCTCGA|AGCGCCGCCCGTTCGCACCTATCTCCCAAA
ACCATTCCCCGACGGTCTAGTCGAGACTGA|CACCGACTCTAGTCTCCTTAACTCTTAAGA
ACCCTTAATTGCAGAAGGAACTATGGTGCC|CCTTAATTGCAGAAGGAGAGACTGATACCC
CCTGTCTGGATACAAGTCGTCGAGACTGAT|TGCAGAAGGAACCCGTCTCGAGACTGATAC
AGGATATCGAGACTGATACCCTTAATTGCA|GATTTTTGGGCCGGGGCTAGCAAAGATGCT
GGAGTAACCCAGTAGTTGTTATCCTTCATA|TTTACACGCATCCAACTAGAGTCATGATAT
CGATGTTCCTATCCGATTCCGGGTGGTACT|TGTACCGATAGTGGTGTTGTTCGAGCAGTC
CTTCGAGACTGATACCCTTAATTGCAGAAG|ATACTAGAGTTGGCATCGAGACTGATATCG
CTTAATTGCAGAAGGAGAGACTGATACCCT|TCGAGACTGATACCCTTAATTGCAGAAGGA
GAAGGACCCTTAATTGCAGAAGGAATCGTG|GGAGAGCCCCCCGGCCTACTAAGTAAATAG
AGAAGGATGTCCTGGGGGTCATACGACCCA|TATCGAGACTGATACCCTTAATTGCAGAAG
CGCCATCAAGCACTTCCGGATCAGCGTCTC|TGCGACCGAAGATTGATAGTGTACATTAAT
TAATTGCAGAAGGATGTCCTGGGGGTCATA|AGACTGATATCGAGACTGATACCCTTAATT
CTAGTAAGAGGATTATTTAACTACCTCGGG|ACTATGGTGCCAGCTCGGCCTATTCTATAC
CTGATACCCTTAATTGCAGAAGGATGTCTG|AAGATACAATACGGTCTCGAGACTGATACC
GATACCCTTAATTGCAGAAGGAACTATGGT|TACCCTTAATTGCAGAAGGAGAGACTGATA
GGTCATTTCCCCACGCTGCGACCGAAGATT|CCAGAACTTGTGGACCTGTCTGGATACAAG
AAAGAGGCTTCGCAGGTCGACACGCATATC|ATGCTAGTAAGAGGATTATTTAACTACCTC
CTGATACCCTTAATTGCAGAAGGACGGAGT|GGGGCTAGCAAAGATGCTTGGCCTGTTTAC
TACAATACGGTCTCGAGACTGATACCCTTA|CAGAAGGACGGAGTAACCCAGTAGTTGTTA
TGCAGAAGGAGAGACTGATACCCTTAATTG|CTTCATAGGGAAAGTCTAAAAAATCGAGAC
AGATCAATCTTTCCGAGGCATAGCAGTCGC|GGTGGACAGTAGGTCATTTCCCCACGCTGC
TCCCCACGCTGCGACCGAAGATTGATAGTG|TTGTGGACCTGTCTGGATACAAGTCGTCGA
TTGCAGAAGGAGAGACTGATACCCTTAATT|CCTTCATAGGGAAAGTCTAAAAAATCGAGA
GCTCGGCCTATTCTATACTAGGTGGAAGCT|TAATTGCAGAAGGAGACAAGATGAGCGCCG
TGTGAATAGAGGAATGAGTTTCACAGGATG|CCCTTAATTGCAGAAGGAGAGACTGATACC
GAGGCTTCGCAGGTCGACACGCATATCAAC|CTAGTAAGAGGATTATTTAACTACCTCGGG
TGGACAGTAGGTCATTTCCCCACGCTGCGA|GTGGATGCACCAGAACTTGTGGACCTGTCT
GAAGGAGACAAGATGAGCGCCGCCCGTTCG|GGGTCATACGACCCAATCAGAGCCGAGATA
CCCTTAATTGCAGAAGGAATCGCCTCGAGA|AAATCGAGACTGATACCCTTAATTGCAGAA
GCTTGGCCTGTTTACACGCATCCAACTAGA|GGCCCTCTACGATAGGGTTGTCCCTCATGG
ATAGGGAAAGTCTAAAAAATCGAGACTGAT|TATCTCGACCGCGATCGCCCCGATGTTCCT
TGGCCTGTTTACACGCATCCAACTAGAGTC|CCTCTACGATAGGGTTGTCCCTCATGGGCG
GTGTTAGGAGAGCCCCCCGGCCTACTAAGT|GAAGGAATCGCCTCGAGACTGATACCCTTA
TTCGCACCTATCTCCCAAATCGAGACTGAT|GATAGAAAAAGTCCGTCGTATGTTCGAGAC
GGTGGCGCAGTGGTGTCGAAAGTACCATTC|ACTAGGTGGAAGCTTTAGAGCCTCGGTATC
ACCCCTCAGAGCGGTAGGCATAGATCAATC|TGCACAGCGTCTTGTTCAGTAGGTGGACAG
ATTATTTAACTACCTCGGGTGGCGCAGTGG|AGCTCGGCCTATTCTATACTAGGTGGAAGC
CCCCACGCTGCGACCGAAGATTGATAGTGT|TGTGGACCTGTCTGGATACAAGTCGTCGAG
TAATTGCAGAAGGAAATTTAAAGCCATACT|GACTGATACCCTTAATTGCAGAAGGATGTC
CTGGATACAAGTCGTCGAGACTGATACCCT|AAGGAACCCGTCTCGAGACTGATACCCTTA
ACGGTCTAGTCGAGACTGATACCCTTAATT|GTCTCCTTAACTCTTAAGATACAATACGGT
TAAAGAGGCTTCGCAGGTCGACACGCATAT|AATGCTAGTAAGAGGATTATTTAACTACCT
AAAAAGTCCGTCGTATGTTCGAGACTGATA|AGGAATCGTGACCATTCCCCGACGGTCTAG
TTTAGAGCCTCGGTATCCTCTCGAGACTGA|GCCCGTTCGCACCTATCTCCCAAATCGAGA
ACAAGTTGTCCAATGCTAGTAAGAGGATTA|TTAATTGCAGAAGGAACTATGGTGCCAGCT
AGACTGATACCCTTAATTGCAGAAGGATGT|CTTAAGATACAATACGGTCTCGAGACTGAT
GAGACTGATACCCTTAATTGCAGAAGGAAC|AATCGAGACTGATACCCTTAATTGCAGAAG
AGAGCCCCCCGGCCTACTAAGTAAATAGCA|CGCCTCGAGACTGATACCCTTAATTGCAGA
TGCAGAAGGATGTCTGTGAATAGAGGAATG|TCTCGAGACTGATACCCTTAATTGCAGAAG
TACCCTTAATTGCAGAAGGAAATTTAAAGC|AGTCGAGACTGATACCCTTAATTGCAGAAG
ACCCAATCAGAGCCGAGATAGAAAAAGTCC|AGAAGGACCCTTAATTGCAGAAGGAATCGT
GCATCGAGACTGATATCGAGACTGATACCC|AGAGGAATGAGTTTCACAGGATGTGGCCTA
GGGTGGCGCAGTGGTGTCGAAAGTACCATT|TACTAGGTGGAAGCTTTAGAGCCTCGGTAT
ATTGCAGAAGGACAACCCCCAATCGTGATG|TCCGGGTGGTACTCGCACCTACGTGACACC
TGTGGACCTGTCTGGATACAAGTCGTCGAG|CTTAATTGCAGAAGGAACCCGTCTCGAGAC
GCGATCGCCCCGATGTTCCTATCCGATTCC|GCACGGGGTATGTACCGATAGTGGTGTTGT
CTGATACCCTTAATTGCAGAAGGAATCGCC|TCTAAAAAATCGAGACTGATACCCTTAATT
AATTGCAGAAGGACCCTTAATTGCAGAAGG|CGTGTTAGGAGAGCCCCCCGGCCTACTAAG
TGATACCCTTAATTGCAGAAGGAGACAAGA|GCAGAAGGATGTCCTGGGGGTCATACGACC
AGTCCGTCGTATGTTCGAGACTGATACCCT|ATCGTGACCATTCCCCGACGGTCTAGTCGA
GCAAAGATGCTTGGCCTGTTTACACGCATC|GTCATTGCGGCCCTCTACGATAGGGTTGTC
GAGACTGATATCGAGACTGATACCCTTAAT|AATGAGTTTCACAGGATGTGGCCTATGCGT
TACTAGAGTTGGCATCGAGACTGATATCGA|TGTCTGTGAATAGAGGAATGAGTTTCACAG
TGCAGAAGGAACCCGTCTCGAGACTGATAC|TAATTGCAGAAGGAGACGCGTTCGTGATAC
CTTGTGGACCTGTCTGGATACAAGTCGTCG|CCCTTAATTGCAGAAGGAACCCGTCTCGAG
ACCAGAACTTGTGGACCTGTCTGGATACAA|ACTGATACCCTTAATTGCAGAAGGAACCCG
CTCGGGTGGCGCAGTGGTGTCGAAAGTACC|CTATACTAGGTGGAAGCTTTAGAGCCTCGG
TGTCTGGATACAAGTCGTCGAGACTGATAC|CAGAAGGAACCCGTCTCGAGACTGATACCC
AATTGCAGAAGGAGACGCGTTCGTGATACT|CCTTAATTGCAGAAGGAAATTTAAAGCCAT
AGATACAATACGGTCTCGAGACTGATACCC|TTGCAGAAGGACGGAGTAACCCAGTAGTTG
TACCCTTAATTGCAGAAGGACGGAGTAACC|CTAGCAAAGATGCTTGGCCTGTTTACACGC
GTTGGCATCGAGACTGATATCGAGACTGAT|GAATAGAGGAATGAGTTTCACAGGATGTGG
AGATAGAAAAAGTCCGTCGTATGTTCGAGA|TGCAGAAGGAATCGTGACCATTCCCCGACG
GATCAATCTTTCCGAGGCATAGCAGTCGCC|GTGGACAGTAGGTCATTTCCCCACGCTGCG
AAATAGCACCGACTCTAGTCTCCTTAACTC|ATTGCAGAAGGATATCGAGACTGATACCCT
GCCTCGGTATCCTCTCGAGACTGATACCCT|TCGCACCTATCTCCCAAATCGAGACTGATA
CCTATCTCCCAAATCGAGACTGATACCCTT|AAAAGTCCGTCGTATGTTCGAGACTGATAC
CCGTCGTATGTTCGAGACTGATACCCTTAA|GTGACCATTCCCCGACGGTCTAGTCGAGAC
ACTGATACCCTTAATTGCAGAAGGACCCTT|ATGTGGCCTATGCGTGTTAGGAGAGCCCCC
CTTAATTGCAGAAGGAACTATGGTGCCAGC|TAATTGCAGAAGGAGAGACTGATACCCTTA
TTCGAGACTGATACCCTTAATTGCAGAAGG|TACTAGAGTTGGCATCGAGACTGATATCGA
GGTCTCGAGACTGATACCCTTAATTGCAGA|CGGAGTAACCCAGTAGTTGTTATCCTTCAT
AAATCGAGACTGATACCCTTAATTGCAGAA|CGTATGTTCGAGACTGATACCCTTAATTGC
TTTCACAGGATGTGGCCTATGCGTGTTAGG|GAGACTGATACCCTTAATTGCAGAAGGAAT
ATTGCAGAAGGAGAGACTGATACCCTTAAT|TCCTTCATAGGGAAAGTCTAAAAAATCGAG
AATTGCAGAAGGATGTCCTGGGGGTCATAC|GACTGATATCGAGACTGATACCCTTAATTG
ATACCCTTAATTGCAGAAGGACAACCCCCA|CTATCCGATTCCGGGTGGTACTCGCACCTA
AGCCCCCCGGCCTACTAAGTAAATAGCACC|CCTCGAGACTGATACCCTTAATTGCAGAAG
GCTGCGACCGAAGATTGATAGTGTACATTA|CCTGTCTGGATACAAGTCGTCGAGACTGAT
GTCTAGTCGAGACTGATACCCTTAATTGCA|TCCTTAACTCTTAAGATACAATACGGTCTC
AGAGACTGATACCCTTAATTGCAGAAGGAG|TTAATTGCAGAAGGATGTCCTGGGGGTCAT
CAGAGCCGAGATAGAAAAAGTCCGTCGTAT|CCCTTAATTGCAGAAGGAATCGTGACCATT
TTGTTATCCTTCATAGGGAAAGTCTAAAAA|CTAGAGTCATGATATCTCGACCGCGATCGC
CCCCGATGTTCCTATCCGATTCCGGGTGGT|GTATGTACCGATAGTGGTGTTGTTCGAGCA
CGCGTTCGTGATACTTCGAGACTGATACCC|GAAATTTAAAGCCATACTAGAGTTGGCATC
TATGGTGCCAGCTCGGCCTATTCTATACTA|CTGATACCCTTAATTGCAGAAGGAGACAAG
TTGTTCAGTAGGTGGACAGTAGGTCATTTC|AAAGTACCATTCGTGGATGCACCAGAACTT
GAGACGCGTTCGTGATACTTCGAGACTGAT|GAAGGAAATTTAAAGCCATACTAGAGTTGG
GTACATTAATAGACAAGTTGTCCAATGCTA|AGACTGATACCCTTAATTGCAGAAGGAACT
AACTACCTCGGGTGGCGCAGTGGTGTCGAA|CCTATTCTATACTAGGTGGAAGCTTTAGAG
GCAGAAGGAAATTTAAAGCCATACTAGAGT|ATACCCTTAATTGCAGAAGGATGTCTGTGA
GAGCCTCGGTATCCTCTCGAGACTGATACC|GTTCGCACCTATCTCCCAAATCGAGACTGA
TGATTTTTGGGCCGGGGCTAGCAAAGATGC|CCCTGGATGTGGGTTTATTAGTCATTGCGG
CCTTAATTGCAGAAGGATGTCCTGGGGGTC|TCGAGACTGATATCGAGACTGATACCCTTA
GAGATAGAAAAAGTCCGTCGTATGTTCGAG|TTGCAGAAGGAATCGTGACCATTCCCCGAC
TTAAAGAGGCTTCGCAGGTCGACACGCATA|CAATGCTAGTAAGAGGATTATTTAACTACC
ATACTTCGAGACTGATACCCTTAATTGCAG|GCCATACTAGAGTTGGCATCGAGACTGATA
CGCCCGTTCGCACCTATCTCCCAAATCGAG|AGCCGAGATAGAAAAAGTCCGTCGTATGTT
CGACGGTCTAGTCGAGACTGATACCCTTAA|TAGTCTCCTTAACTCTTAAGATACAATACG
CGAGATAGAAAAAGTCCGTCGTATGTTCGA|ATTGCAGAAGGAATCGTGACCATTCCCCGA
AGGACGGAGTAACCCAGTAGTTGTTATCCT|GCCTGTTTACACGCATCCAACTAGAGTCAT
GACTGATACCCTTAATTGCAGAAGGACCCT|GATGTGGCCTATGCGTGTTAGGAGAGCCCC
AGTTGTTATCCTTCATAGGGAAAGTCTAAA|AACTAGAGTCATGATATCTCGACCGCGATC
GATACCCTTAATTGCAGAAGGATGTCCTGG|TGGCATCGAGACTGATATCGAGACTGATAC
GACTGATACCCTTAATTGCAGAAGGATGTC|TTAAGATACAATACGGTCTCGAGACTGATA
TCCTTCATAGGGAAAGTCTAAAAAATCGAG|TCATGATATCTCGACCGCGATCGCCCCGAT
GCTTCGCAGGTCGACACGCATATCAACCTG|GTAAGAGGATTATTTAACTACCTCGGGTGG
GGACAGTAGGTCATTTCCCCACGCTGCGAC|TGGATGCACCAGAACTTGTGGACCTGTCTG
CATGATATCTCGACCGCGATCGCCCCGATG|GCTCCGTATGGCCCAGCACGGGGTATGTAC
CTTAATTGCAGAAGGATGTCTGTGAATAGA|ATACGGTCTCGAGACTGATACCCTTAATTG
AGAGCCGAGATAGAAAAAGTCCGTCGTATG|CCTTAATTGCAGAAGGAATCGTGACCATTC
TCGAGACTGATACCCTTAATTGCAGAAGGA|CAAATCGAGACTGATACCCTTAATTGCAGA
CGACCGAAGATTGATAGTGTACATTAATAG|TCTGGATACAAGTCGTCGAGACTGATACCC
CCCCCCGGCCTACTAAGTAAATAGCACCGA|TCGAGACTGATACCCTTAATTGCAGAAGGA
AGACTGATACCCTTAATTGCAGAAGGAGAC|TTCGAGACTGATACCCTTAATTGCAGAAGG
GTGATGATTTTTGGGCCGGGGCTAGCAAAG|GACACCCTGGATGTGGGTTTATTAGTCATT
ACTGATACCCTTAATTGCAGAAGGAGAGAC|CGTGATACTTCGAGACTGATACCCTTAATT
GATACTTCGAGACTGATACCCTTAATTGCA|AGCCATACTAGAGTTGGCATCGAGACTGAT
AGAAGGACGGAGTAACCCAGTAGTTGTTAT|TTGGCCTGTTTACACGCATCCAACTAGAGT
TAGTAAGAGGATTATTTAACTACCTCGGGT|CTATGGTGCCAGCTCGGCCTATTCTATACT
GAAATTTAAAGCCATACTAGAGTTGGCATC|TAATTGCAGAAGGATGTCTGTGAATAGAGG
GGAATCGCCTCGAGACTGATACCCTTAATT|CCCTTAATTGCAGAAGGACAACCCCCAATC
GACCGCGATCGCCCCGATGTTCCTATCCGA|CCCAGCACGGGGTATGTACCGATAGTGGTG
GGTCGACACGCATATCAACCTGCGTGCACA|ATTATTTAACTACCTCGGGTGGCGCAGTGG
ATACCCTTAATTGCAGAAGGAGAGACTGAT|TAGTTGTTATCCTTCATAGGGAAAGTCTAA
GCATAGCAGTCGCCATCAAGCACTTCCGGA|TTCCCCACGCTGCGACCGAAGATTGATAGT
AGTAAATAGCACCGACTCTAGTCTCCTTAA|TTAATTGCAGAAGGATATCGAGACTGATAC
GTAAATAGCACCGACTCTAGTCTCCTTAAC|TAATTGCAGAAGGATATCGAGACTGATACC
ATAGATCAATCTTTCCGAGGCATAGCAGTC|TAGGTGGACAGTAGGTCATTTCCCCACGCT
TCTCCCAAATCGAGACTGATACCCTTAATT|GTCCGTCGTATGTTCGAGACTGATACCCTT
GCATAGATCAATCTTTCCGAGGCATAGCAG|AGTAGGTGGACAGTAGGTCATTTCCCCACG
TGCGTGCACAGCGTCTTGTTCAGTAGGTGG|GGCGCAGTGGTGTCGAAAGTACCATTCGTG
AGTCTAAAAAATCGAGACTGATACCCTTAA|CCGCGATCGCCCCGATGTTCCTATCCGATT
ACCCTTAATTGCAGAAGGAGAGACTGATAC|GTTGTTATCCTTCATAGGGAAAGTCTAAAA
AGTCATGATATCTCGACCGCGATCGCCCCG|GGCGCTCCGTATGGCCCAGCACGGGGTATG
GCCCCGATGTTCCTATCCGATTCCGGGTGG|GGTATGTACCGATAGTGGTGTTGTTCGAGC
CTAAAAAATCGAGACTGATACCCTTAATTG|CGATCGCCCCGATGTTCCTATCCGATTCCG
ACAAGTCGTCGAGACTGATACCCTTAATTG|CCCGTCTCGAGACTGATACCCTTAATTGCA
TTAATTGCAGAAGGAGACAAGATGAGCGCC|ATGTCCTGGGGGTCATACGACCCAATCAGA
GGTGGACAGTAGGTCATTTCCCCACGCTGC|TCGTGGATGCACCAGAACTTGTGGACCTGT
TCTCGAGACTGATACCCTTAATTGCAGAAG|CCCAAATCGAGACTGATACCCTTAATTGCA
CGAGACTGATACCCTTAATTGCAGAAGGAG|CGTTCGTGATACTTCGAGACTGATACCCTT
ACCTATCTCCCAAATCGAGACTGATACCCT|AAAAAGTCCGTCGTATGTTCGAGACTGATA
TACCCTTAATTGCAGAAGGAGAGACTGATA|AGTTGTTATCCTTCATAGGGAAAGTCTAAA
CAGCGTCTCAGGCAGCTGACGTTAAAGAGG|TACATTAATAGACAAGTTGTCCAATGCTAG
TAAGAGGATTATTTAACTACCTCGGGTGGC|TGGTGCCAGCTCGGCCTATTCTATACTAGG
TCGCCCCGATGTTCCTATCCGATTCCGGGT|GGGGTATGTACCGATAGTGGTGTTGTTCGA
GGGAAAGTCTAAAAAATCGAGACTGATACC|CTCGACCGCGATCGCCCCGATGTTCCTATC
GGCTTCGCAGGTCGACACGCATATCAACCT|AGTAAGAGGATTATTTAACTACCTCGGGTG
CCGGATCAGCGTCTCAGGCAGCTGACGTTA|ATAGTGTACATTAATAGACAAGTTGTCCAA
CCCAATCGTGATGATTTTTGGGCCGGGGCT|CCTACGTGACACCCTGGATGTGGGTTTATT
AGCTGACGTTAAAGAGGCTTCGCAGGTCGA|AAGTTGTCCAATGCTAGTAAGAGGATTATT
GCGTCTCAGGCAGCTGACGTTAAAGAGGCT|CATTAATAGACAAGTTGTCCAATGCTAGTA
GTCATTTCCCCACGCTGCGACCGAAGATTG|CAGAACTTGTGGACCTGTCTGGATACAAGT
CCCTTAATTGCAGAAGGACAACCCCCAATC|TCCGATTCCGGGTGGTACTCGCACCTACGT
TGCACAGCGTCTTGTTCAGTAGGTGGACAG|CAGTGGTGTCGAAAGTACCATTCGTGGATG
GCACTTCCGGATCAGCGTCTCAGGCAGCTG|AGATTGATAGTGTACATTAATAGACAAGTT
TACAAGTCGTCGAGACTGATACCCTTAATT|ACCCGTCTCGAGACTGATACCCTTAATTGC
GAACTTGTGGACCTGTCTGGATACAAGTCG|ATACCCTTAATTGCAGAAGGAACCCGTCTC
GACTGATACCCTTAATTGCAGAAGGAACCC|TCGAGACTGATACCCTTAATTGCAGAAGGA
AGGCATAGCAGTCGCCATCAAGCACTTCCG|ATTTCCCCACGCTGCGACCGAAGATTGATA
TCTGTGAATAGAGGAATGAGTTTCACAGGA|TACCCTTAATTGCAGAAGGAGAGACTGATA
TTCCGGATCAGCGTCTCAGGCAGCTGACGT|TGATAGTGTACATTAATAGACAAGTTGTCC
GATACCCTTAATTGCAGAAGGACGGAGTAA|GGCTAGCAAAGATGCTTGGCCTGTTTACAC
AGGATGTCTGTGAATAGAGGAATGAGTTTC|GACTGATACCCTTAATTGCAGAAGGAGAGA
TCATGATATCTCGACCGCGATCGCCCCGAT|CGCTCCGTATGGCCCAGCACGGGGTATGTA
TCGTGGATGCACCAGAACTTGTGGACCTGT|TCCTCTCGAGACTGATACCCTTAATTGCAG
TGGTGCCAGCTCGGCCTATTCTATACTAGG|GATACCCTTAATTGCAGAAGGAGACAAGAT
CAGAAGGAGACAAGATGAGCGCCGCCCGTT|GGGGGTCATACGACCCAATCAGAGCCGAGA
TGCAGAAGGACGGAGTAACCCAGTAGTTGT|TGCTTGGCCTGTTTACACGCATCCAACTAG
CCGTCTCGAGACTGATACCCTTAATTGCAG|GAGACGCGTTCGTGATACTTCGAGACTGAT
AGTAGTTGTTATCCTTCATAGGGAAAGTCT|TCCAACTAGAGTCATGATATCTCGACCGCG
GTCATGATATCTCGACCGCGATCGCCCCGA|GCGCTCCGTATGGCCCAGCACGGGGTATGT
TATCTCGACCGCGATCGCCCCGATGTTCCT|GTATGGCCCAGCACGGGGTATGTACCGATA
CGCATCCAACTAGAGTCATGATATCTCGAC|GTTGTCCCTCATGGGCGCTCCGTATGGCCC
AGCACCGACTCTAGTCTCCTTAACTCTTAA|CAGAAGGATATCGAGACTGATACCCTTAAT
GAGACTGATACCCTTAATTGCAGAAGGATA|AGAAGGACAACCCCCAATCGTGATGATTTT
TCAGCGTCTCAGGCAGCTGACGTTAAAGAG|GTACATTAATAGACAAGTTGTCCAATGCTA
AGAAGGATGTCTGTGAATAGAGGAATGAGT|CGAGACTGATACCCTTAATTGCAGAAGGAG
ATCGTGACCATTCCCCGACGGTCTAGTCGA|AAATAGCACCGACTCTAGTCTCCTTAACTC
CAATCGTGATGATTTTTGGGCCGGGGCTAG|TACGTGACACCCTGGATGTGGGTTTATTAG
GAAGGATGTCTGTGAATAGAGGAATGAGTT|GAGACTGATACCCTTAATTGCAGAAGGAGA
GGCCGGGGCTAGCAAAGATGCTTGGCCTGT|TGGGTTTATTAGTCATTGCGGCCCTCTACG
TAGGTCATTTCCCCACGCTGCGACCGAAGA|CACCAGAACTTGTGGACCTGTCTGGATACA
CTGATATCGAGACTGATACCCTTAATTGCA|AGTTTCACAGGATGTGGCCTATGCGTGTTA
CAAGTCGTCGAGACTGATACCCTTAATTGC|CCGTCTCGAGACTGATACCCTTAATTGCAG
GCCTACTAAGTAAATAGCACCGACTCTAGT|TGATACCCTTAATTGCAGAAGGATATCGAG
ATGCGTGTTAGGAGAGCCCCCCGGCCTACT|TGCAGAAGGAATCGCCTCGAGACTGATACC
TCCAATGCTAGTAAGAGGATTATTTAACTA|AGAAGGAACTATGGTGCCAGCTCGGCCTAT
ACAACCCCCAATCGTGATGATTTTTGGGCC|CTCGCACCTACGTGACACCCTGGATGTGGG
GGAACTATGGTGCCAGCTCGGCCTATTCTA|AGAGACTGATACCCTTAATTGCAGAAGGAG
TAGTGTACATTAATAGACAAGTTGTCCAAT|GTCGAGACTGATACCCTTAATTGCAGAAGG
ATTGCAGAAGGAATCGTGACCATTCCCCGA|GGCCTACTAAGTAAATAGCACCGACTCTAG
GTCCGTCGTATGTTCGAGACTGATACCCTT|TCGTGACCATTCCCCGACGGTCTAGTCGAG
TTAATTGCAGAAGGATATCGAGACTGATAC|CCAATCGTGATGATTTTTGGGCCGGGGCTA
TGCGTGTTAGGAGAGCCCCCCGGCCTACTA|GCAGAAGGAATCGCCTCGAGACTGATACCC
CAGGTCGACACGCATATCAACCTGCGTGCA|GGATTATTTAACTACCTCGGGTGGCGCAGT
GGATTATTTAACTACCTCGGGTGGCGCAGT|CCAGCTCGGCCTATTCTATACTAGGTGGAA
GCGTGTTAGGAGAGCCCCCCGGCCTACTAA|CAGAAGGAATCGCCTCGAGACTGATACCCT
GAACTATGGTGCCAGCTCGGCCTATTCTAT|GAGACTGATACCCTTAATTGCAGAAGGAGA
GGCGCAGTGGTGTCGAAAGTACCATTCGTG|AGGTGGAAGCTTTAGAGCCTCGGTATCCTC
AATCGTGATGATTTTTGGGCCGGGGCTAGC|ACGTGACACCCTGGATGTGGGTTTATTAGT
AAGGATGTCCTGGGGGTCATACGACCCAAT|TCGAGACTGATACCCTTAATTGCAGAAGGA
AATACGGTCTCGAGACTGATACCCTTAATT|AAGGACGGAGTAACCCAGTAGTTGTTATCC
AACCCCTCAGAGCGGTAGGCATAGATCAAT|GTGCACAGCGTCTTGTTCAGTAGGTGGACA
TTCTATACTAGGTGGAAGCTTTAGAGCCTC|AGGAGACAAGATGAGCGCCGCCCGTTCGCA
CCAGAACTTGTGGACCTGTCTGGATACAAG|CTGATACCCTTAATTGCAGAAGGAACCCGT
TGTGGCCTATGCGTGTTAGGAGAGCCCCCC|CCCTTAATTGCAGAAGGAATCGCCTCGAGA
AGAGTCATGATATCTCGACCGCGATCGCCC|TGGGCGCTCCGTATGGCCCAGCACGGGGTA
AGAAGGACAACCCCCAATCGTGATGATTTT|GTGGTACTCGCACCTACGTGACACCCTGGA
GCGACCGAAGATTGATAGTGTACATTAATA|GTCTGGATACAAGTCGTCGAGACTGATACC
GAGAGACTGATACCCTTAATTGCAGAAGGA|CTTAATTGCAGAAGGATGTCCTGGGGGTCA
TTGCAGAAGGATATCGAGACTGATACCCTT|TCGTGATGATTTTTGGGCCGGGGCTAGCAA
GATACCCTTAATTGCAGAAGGATATCGAGA|ACAACCCCCAATCGTGATGATTTTTGGGCC
GCAGAAGGAATCGCCTCGAGACTGATACCC|CTGATACCCTTAATTGCAGAAGGACAACCC
GATACCCTTAATTGCAGAAGGAACCCGTCT|GACTGATACCCTTAATTGCAGAAGGAGACG
ACCTGCGTGCACAGCGTCTTGTTCAGTAGG|GGTGGCGCAGTGGTGTCGAAAGTACCATTC
TATTCTATACTAGGTGGAAGCTTTAGAGCC|GAAGGAGACAAGATGAGCGCCGCCCGTTCG
AAGTCTAAAAAATCGAGACTGATACCCTTA|ACCGCGATCGCCCCGATGTTCCTATCCGAT
CGGTCTCGAGACTGATACCCTTAATTGCAG|ACGGAGTAACCCAGTAGTTGTTATCCTTCA
CATACTAGAGTTGGCATCGAGACTGATATC|GATGTCTGTGAATAGAGGAATGAGTTTCAC
ACTGATACCCTTAATTGCAGAAGGATATCG|AGGACAACCCCCAATCGTGATGATTTTTGG
TTGTCCAATGCTAGTAAGAGGATTATTTAA|TGCAGAAGGAACTATGGTGCCAGCTCGGCC
TAATAGACAAGTTGTCCAATGCTAGTAAGA|ATACCCTTAATTGCAGAAGGAACTATGGTG
TTGCAGAAGGAATCGTGACCATTCCCCGAC|GCCTACTAAGTAAATAGCACCGACTCTAGT
CGAGACTGATACCCTTAATTGCAGAAGGAG|TAACCCAGTAGTTGTTATCCTTCATAGGGA
GAGGATTATTTAACTACCTCGGGTGGCGCA|TGCCAGCTCGGCCTATTCTATACTAGGTGG
CTTAATTGCAGAAGGAGAGACTGATACCCT|GTTATCCTTCATAGGGAAAGTCTAAAAAAT
CCTTAATTGCAGAAGGAGAGACTGATACCC|TGTTATCCTTCATAGGGAAAGTCTAAAAAA
GCAGAAGGATGTCTGTGAATAGAGGAATGA|CTCGAGACTGATACCCTTAATTGCAGAAGG
ATTCTATACTAGGTGGAAGCTTTAGAGCCT|AAGGAGACAAGATGAGCGCCGCCCGTTCGC
AACTATGGTGCCAGCTCGGCCTATTCTATA|AGACTGATACCCTTAATTGCAGAAGGAGAC
TTTACACGCATCCAACTAGAGTCATGATAT|GATAGGGTTGTCCCTCATGGGCGCTCCGTA
GAAGGAATCGTGACCATTCCCCGACGGTCT|CTAAGTAAATAGCACCGACTCTAGTCTCCT
CCCGTCTCGAGACTGATACCCTTAATTGCA|GGAGACGCGTTCGTGATACTTCGAGACTGA
AAGGAGAGACTGATACCCTTAATTGCAGAA|ACCCTTAATTGCAGAAGGATGTCCTGGGGG
GCAGAAGGACAACCCCCAATCGTGATGATT|GGGTGGTACTCGCACCTACGTGACACCCTG
TTCCTATCCGATTCCGGGTGGTACTCGCAC|CGATAGTGGTGTTGTTCGAGCAGTCCGCAT
TCATTTCCCCACGCTGCGACCGAAGATTGA|AGAACTTGTGGACCTGTCTGGATACAAGTC
GTTGTTATCCTTCATAGGGAAAGTCTAAAA|ACTAGAGTCATGATATCTCGACCGCGATCG
GCAGAAGGATATCGAGACTGATACCCTTAA|GTGATGATTTTTGGGCCGGGGCTAGCAAAG
CTAGGTGGAAGCTTTAGAGCCTCGGTATCC|AAGATGAGCGCCGCCCGTTCGCACCTATCT
GATACCCTTAATTGCAGAAGGAATCGCCTC|TAAAAAATCGAGACTGATACCCTTAATTGC
CTCGAGACTGATACCCTTAATTGCAGAAGG|TGCAGAAGGACAACCCCCAATCGTGATGAT
ATGTTCCTATCCGATTCCGGGTGGTACTCG|TACCGATAGTGGTGTTGTTCGAGCAGTCCG
GCAGAAGGATGTCCTGGGGGTCATACGACC|GATATCGAGACTGATACCCTTAATTGCAGA
ACCCTTAATTGCAGAAGGAGAGACTGATAC|ACTTCGAGACTGATACCCTTAATTGCAGAA
TCGAGACTGATACCCTTAATTGCAGAAGGA|GAGACTGATACCCTTAATTGCAGAAGGAGA
CGGTATCCTCTCGAGACTGATACCCTTAAT|ACCTATCTCCCAAATCGAGACTGATACCCT
ACGGAGTAACCCAGTAGTTGTTATCCTTCA|TGTTTACACGCATCCAACTAGAGTCATGAT
GAGACTGATACCCTTAATTGCAGAAGGACA|GATGTTCCTATCCGATTCCGGGTGGTACTC
TAGCACCGACTCTAGTCTCCTTAACTCTTA|GCAGAAGGATATCGAGACTGATACCCTTAA
AGTCGTCGAGACTGATACCCTTAATTGCAG|GTCTCGAGACTGATACCCTTAATTGCAGAA
AAAAATCGAGACTGATACCCTTAATTGCAG|TCGCCCCGATGTTCCTATCCGATTCCGGGT
CCCTTAATTGCAGAAGGATATCGAGACTGA|CCCCCAATCGTGATGATTTTTGGGCCGGGG
ACCCCCAATCGTGATGATTTTTGGGCCGGG|GCACCTACGTGACACCCTGGATGTGGGTTT
ACTAGGTGGAAGCTTTAGAGCCTCGGTATC|CAAGATGAGCGCCGCCCGTTCGCACCTATC
CGGCCTATTCTATACTAGGTGGAAGCTTTA|TTGCAGAAGGAGACAAGATGAGCGCCGCCC
AGCGTCTTGTTCAGTAGGTGGACAGTAGGT|GTGTCGAAAGTACCATTCGTGGATGCACCA
CGGGGCTAGCAAAGATGCTTGGCCTGTTTA|GTTTATTAGTCATTGCGGCCCTCTACGATA
GCATATCAACCTGCGTGCACAGCGTCTTGT|CTACCTCGGGTGGCGCAGTGGTGTCGAAAG
GTAGGCATAGATCAATCTTTCCGAGGCATA|GTTCAGTAGGTGGACAGTAGGTCATTTCCC
GTATGTTCGAGACTGATACCCTTAATTGCA|CATTCCCCGACGGTCTAGTCGAGACTGATA
GTGATACTTCGAGACTGATACCCTTAATTG|AAAGCCATACTAGAGTTGGCATCGAGACTG
CAGAAGGATGTCTGTGAATAGAGGAATGAG|TCGAGACTGATACCCTTAATTGCAGAAGGA
ATACCCTTAATTGCAGAAGGATATCGAGAC|CAACCCCCAATCGTGATGATTTTTGGGCCG
AGGAATGAGTTTCACAGGATGTGGCCTATG|GCAGAAGGAGAGACTGATACCCTTAATTGC
TGTTCAGTAGGTGGACAGTAGGTCATTTCC|AAGTACCATTCGTGGATGCACCAGAACTTG
AGCAGTCGCCATCAAGCACTTCCGGATCAG|CCACGCTGCGACCGAAGATTGATAGTGTAC
ACACGCATATCAACCTGCGTGCACAGCGTC|TTAACTACCTCGGGTGGCGCAGTGGTGTCG
ATTGCAGAAGGAATCGCCTCGAGACTGATA|AGACTGATACCCTTAATTGCAGAAGGACAA
CGTGTTAGGAGAGCCCCCCGGCCTACTAAG|AGAAGGAATCGCCTCGAGACTGATACCCTT
ATTGCAGAAGGAACTATGGTGCCAGCTCGG|TGCAGAAGGAGAGACTGATACCCTTAATTG
ATCGAGACTGATACCCTTAATTGCAGAAGG|CACAGGATGTGGCCTATGCGTGTTAGGAGA
AACCCGTCTCGAGACTGATACCCTTAATTG|AAGGAGACGCGTTCGTGATACTTCGAGACT
TAATTGCAGAAGGAGAGACTGATACCCTTA|GAGACTGATACCCTTAATTGCAGAAGGATG
CCCCTCAGAGCGGTAGGCATAGATCAATCT|GCACAGCGTCTTGTTCAGTAGGTGGACAGT
CTACTAAGTAAATAGCACCGACTCTAGTCT|ATACCCTTAATTGCAGAAGGATATCGAGAC
CCTCGGGTGGCGCAGTGGTGTCGAAAGTAC|TCTATACTAGGTGGAAGCTTTAGAGCCTCG
ATCCTTCATAGGGAAAGTCTAAAAAATCGA|GTCATGATATCTCGACCGCGATCGCCCCGA
TTCACAGGATGTGGCCTATGCGTGTTAGGA|AGACTGATACCCTTAATTGCAGAAGGAATC
CTATGGTGCCAGCTCGGCCTATTCTATACT|ACTGATACCCTTAATTGCAGAAGGAGACAA
CTAGAGTCATGATATCTCGACCGCGATCGC|CATGGGCGCTCCGTATGGCCCAGCACGGGG
ATACCCTTAATTGCAGAAGGATGTCCTGGG|GGCATCGAGACTGATATCGAGACTGATACC
TTAGGAGAGCCCCCCGGCCTACTAAGTAAA|GGAATCGCCTCGAGACTGATACCCTTAATT
ACAATACGGTCTCGAGACTGATACCCTTAA|AGAAGGACGGAGTAACCCAGTAGTTGTTAT
ACTGATACCCTTAATTGCAGAAGGAGAGAC|CCAGTAGTTGTTATCCTTCATAGGGAAAGT
TATCGAGACTGATACCCTTAATTGCAGAAG|TTTGGGCCGGGGCTAGCAAAGATGCTTGGC
CGTGCACAGCGTCTTGTTCAGTAGGTGGAC|CGCAGTGGTGTCGAAAGTACCATTCGTGGA
ATTGCAGAAGGAAATTTAAAGCCATACTAG|CTGATACCCTTAATTGCAGAAGGATGTCTG
CCAAATCGAGACTGATACCCTTAATTGCAG|GTCGTATGTTCGAGACTGATACCCTTAATT
CCCCGACGGTCTAGTCGAGACTGATACCCT|CTCTAGTCTCCTTAACTCTTAAGATACAAT
GCCCCCCGGCCTACTAAGTAAATAGCACCG|CTCGAGACTGATACCCTTAATTGCAGAAGG
GGAGACAAGATGAGCGCCGCCCGTTCGCAC|TCATACGACCCAATCAGAGCCGAGATAGAA
ATGAGCGCCGCCCGTTCGCACCTATCTCCC|CCAATCAGAGCCGAGATAGAAAAAGTCCGT
GCCTATTCTATACTAGGTGGAAGCTTTAGA|GCAGAAGGAGACAAGATGAGCGCCGCCCGT
TCTCCTTAACTCTTAAGATACAATACGGTC|GACTGATACCCTTAATTGCAGAAGGACGGA
TGCTTGGCCTGTTTACACGCATCCAACTAG|CGGCCCTCTACGATAGGGTTGTCCCTCATG
AAGGACCCTTAATTGCAGAAGGAATCGTGA|GAGAGCCCCCCGGCCTACTAAGTAAATAGC
ACTTGTGGACCTGTCTGGATACAAGTCGTC|ACCCTTAATTGCAGAAGGAACCCGTCTCGA
GGAATCGTGACCATTCCCCGACGGTCTAGT|AGTAAATAGCACCGACTCTAGTCTCCTTAA
TATCGAGACTGATACCCTTAATTGCAGAAG|TCACAGGATGTGGCCTATGCGTGTTAGGAG
ATTGCAGAAGGATATCGAGACTGATACCCT|ATCGTGATGATTTTTGGGCCGGGGCTAGCA
ATACCCTTAATTGCAGAAGGAGACGCGTTC|ACTGATACCCTTAATTGCAGAAGGAAATTT
TGGATACAAGTCGTCGAGACTGATACCCTT|AGGAACCCGTCTCGAGACTGATACCCTTAA
CAGAAGGAACCCGTCTCGAGACTGATACCC|ATTGCAGAAGGAGACGCGTTCGTGATACTT
AGGTCATTTCCCCACGCTGCGACCGAAGAT|ACCAGAACTTGTGGACCTGTCTGGATACAA
TTCCCCACGCTGCGACCGAAGATTGATAGT|CTTGTGGACCTGTCTGGATACAAGTCGTCG
TCGACACGCATATCAACCTGCGTGCACAGC|TATTTAACTACCTCGGGTGGCGCAGTGGTG
GCAGAAGGAGACAAGATGAGCGCCGCCCGT|TGGGGGTCATACGACCCAATCAGAGCCGAG
TTGCAGAAGGACCCTTAATTGCAGAAGGAA|TGTTAGGAGAGCCCCCCGGCCTACTAAGTA
ACCATTCGTGGATGCACCAGAACTTGTGGA|CGGTATCCTCTCGAGACTGATACCCTTAAT
CGCAGGTCGACACGCATATCAACCTGCGTG|GAGGATTATTTAACTACCTCGGGTGGCGCA
CGAGACTGATACCCTTAATTGCAGAAGGAA|CGACGGTCTAGTCGAGACTGATACCCTTAA
AGACTGATACCCTTAATTGCAGAAGGACCC|GGATGTGGCCTATGCGTGTTAGGAGAGCCC
GAAAAAGTCCGTCGTATGTTCGAGACTGAT|AAGGAATCGTGACCATTCCCCGACGGTCTA
AGAAGGAACTATGGTGCCAGCTCGGCCTAT|AAGGAGAGACTGATACCCTTAATTGCAGAA
GTCTCGAGACTGATACCCTTAATTGCAGAA|GGAGTAACCCAGTAGTTGTTATCCTTCATA
CAAATCGAGACTGATACCCTTAATTGCAGA|TCGTATGTTCGAGACTGATACCCTTAATTG
AATTTAAAGCCATACTAGAGTTGGCATCGA|ATTGCAGAAGGATGTCTGTGAATAGAGGAA
GGCCTATTCTATACTAGGTGGAAGCTTTAG|TGCAGAAGGAGACAAGATGAGCGCCGCCCG
TTATTTAACTACCTCGGGTGGCGCAGTGGT|GCTCGGCCTATTCTATACTAGGTGGAAGCT
GAGGAATGAGTTTCACAGGATGTGGCCTAT|TGCAGAAGGAGAGACTGATACCCTTAATTG
AGTAAGAGGATTATTTAACTACCTCGGGTG|TATGGTGCCAGCTCGGCCTATTCTATACTA
TTAATTGCAGAAGGACAACCCCCAATCGTG|GATTCCGGGTGGTACTCGCACCTACGTGAC
AGCGGTAGGCATAGATCAATCTTTCCGAGG|TCTTGTTCAGTAGGTGGACAGTAGGTCATT
CGCCTCGAGACTGATACCCTTAATTGCAGA|AATTGCAGAAGGACAACCCCCAATCGTGAT
AGAAGGAATCGCCTCGAGACTGATACCCTT|GATACCCTTAATTGCAGAAGGACAACCCCC
TACCCTTAATTGCAGAAGGATATCGAGACT|AACCCCCAATCGTGATGATTTTTGGGCCGG
CTGTCTGGATACAAGTCGTCGAGACTGATA|GCAGAAGGAACCCGTCTCGAGACTGATACC
CAATACGGTCTCGAGACTGATACCCTTAAT|GAAGGACGGAGTAACCCAGTAGTTGTTATC
GATACCCTTAATTGCAGAAGGAGACAAGAT|CAGAAGGATGTCCTGGGGGTCATACGACCC
ATACCCTTAATTGCAGAAGGAAATTTAAAG|TAGTCGAGACTGATACCCTTAATTGCAGAA
AATTGCAGAAGGATGTCTGTGAATAGAGGA|CGGTCTCGAGACTGATACCCTTAATTGCAG
TCCTCTCGAGACTGATACCCTTAATTGCAG|TCTCCCAAATCGAGACTGATACCCTTAATT
AGGAGAGCCCCCCGGCCTACTAAGTAAATA|AATCGCCTCGAGACTGATACCCTTAATTGC
TGAGCGCCGCCCGTTCGCACCTATCTCCCA|CAATCAGAGCCGAGATAGAAAAAGTCCGTC
CCTTAATTGCAGAAGGAGACAAGATGAGCG|GGATGTCCTGGGGGTCATACGACCCAATCA
CGTTCGCACCTATCTCCCAAATCGAGACTG|GAGATAGAAAAAGTCCGTCGTATGTTCGAG
AACTTGTGGACCTGTCTGGATACAAGTCGT|TACCCTTAATTGCAGAAGGAACCCGTCTCG
CTTCATAGGGAAAGTCTAAAAAATCGAGAC|ATGATATCTCGACCGCGATCGCCCCGATGT
ATTGCAGAAGGAGACGCGTTCGTGATACTT|CTTAATTGCAGAAGGAAATTTAAAGCCATA
GTGGCGCAGTGGTGTCGAAAGTACCATTCG|CTAGGTGGAAGCTTTAGAGCCTCGGTATCC
TAGGTGGACAGTAGGTCATTTCCCCACGCT|ATTCGTGGATGCACCAGAACTTGTGGACCT
TCGAGACTGATACCCTTAATTGCAGAAGGA|ATGTTCGAGACTGATACCCTTAATTGCAGA
GGCATCGAGACTGATATCGAGACTGATACC|TAGAGGAATGAGTTTCACAGGATGTGGCCT
ACTGATACCCTTAATTGCAGAAGGAATCGC|GTCTAAAAAATCGAGACTGATACCCTTAAT
TTGGGCCGGGGCTAGCAAAGATGCTTGGCC|ATGTGGGTTTATTAGTCATTGCGGCCCTCT
TAATTGCAGAAGGATATCGAGACTGATACC|CAATCGTGATGATTTTTGGGCCGGGGCTAG
TCGAGACTGATATCGAGACTGATACCCTTA|GGAATGAGTTTCACAGGATGTGGCCTATGC
GCAGAAGGAGAGACTGATACCCTTAATTGC|TTCATAGGGAAAGTCTAAAAAATCGAGACT
CAGAAGGAGAGACTGATACCCTTAATTGCA|TCATAGGGAAAGTCTAAAAAATCGAGACTG
TAGGCATAGATCAATCTTTCCGAGGCATAG|TTCAGTAGGTGGACAGTAGGTCATTTCCCC
GACCTGTCTGGATACAAGTCGTCGAGACTG|ATTGCAGAAGGAACCCGTCTCGAGACTGAT
CCCAATCAGAGCCGAGATAGAAAAAGTCCG|GAAGGACCCTTAATTGCAGAAGGAATCGTG
CCCTTAATTGCAGAAGGAGACAAGATGAGC|AGGATGTCCTGGGGGTCATACGACCCAATC
GATACCCTTAATTGCAGAAGGACAACCCCC|CCTATCCGATTCCGGGTGGTACTCGCACCT
TCGAAAGTACCATTCGTGGATGCACCAGAA|TAGAGCCTCGGTATCCTCTCGAGACTGATA
CTAGAGTTGGCATCGAGACTGATATCGAGA|TCTGTGAATAGAGGAATGAGTTTCACAGGA
GACTGATACCCTTAATTGCAGAAGGAGACG|TCGAGACTGATACCCTTAATTGCAGAAGGA
CCGAGATAGAAAAAGTCCGTCGTATGTTCG|AATTGCAGAAGGAATCGTGACCATTCCCCG
CACGCATCCAACTAGAGTCATGATATCTCG|GGGTTGTCCCTCATGGGCGCTCCGTATGGC
GACAAGTTGTCCAATGCTAGTAAGAGGATT|CTTAATTGCAGAAGGAACTATGGTGCCAGC
GTGGTGTCGAAAGTACCATTCGTGGATGCA|AAGCTTTAGAGCCTCGGTATCCTCTCGAGA
ATTGCAGAAGGATGTCTGTGAATAGAGGAA|GGTCTCGAGACTGATACCCTTAATTGCAGA
TGATACCCTTAATTGCAGAAGGAGAGACTG|AGTAGTTGTTATCCTTCATAGGGAAAGTCT
TAATTGCAGAAGGACAACCCCCAATCGTGA|ATTCCGGGTGGTACTCGCACCTACGTGACA
CTCGAGACTGATACCCTTAATTGCAGAAGG|CGCGTTCGTGATACTTCGAGACTGATACCC
ATCTCGACCGCGATCGCCCCGATGTTCCTA|TATGGCCCAGCACGGGGTATGTACCGATAG
GCTAGCAAAGATGCTTGGCCTGTTTACACG|ATTAGTCATTGCGGCCCTCTACGATAGGGT
TAATTGCAGAAGGAATCGTGACCATTCCCC|CCGGCCTACTAAGTAAATAGCACCGACTCT
GGATCAGCGTCTCAGGCAGCTGACGTTAAA|AGTGTACATTAATAGACAAGTTGTCCAATG
CCACGCTGCGACCGAAGATTGATAGTGTAC|TGGACCTGTCTGGATACAAGTCGTCGAGAC
TGATACTTCGAGACTGATACCCTTAATTGC|AAGCCATACTAGAGTTGGCATCGAGACTGA
AGGAATCGTGACCATTCCCCGACGGTCTAG|AAGTAAATAGCACCGACTCTAGTCTCCTTA
TTAACTACCTCGGGTGGCGCAGTGGTGTCG|GGCCTATTCTATACTAGGTGGAAGCTTTAG
ATTTAAAGCCATACTAGAGTTGGCATCGAG|TTGCAGAAGGATGTCTGTGAATAGAGGAAT
TACCCTTAATTGCAGAAGGAACCCGTCTCG|CTGATACCCTTAATTGCAGAAGGAGACGCG
ACTAGAGTTGGCATCGAGACTGATATCGAG|GTCTGTGAATAGAGGAATGAGTTTCACAGG
ATACGACCCAATCAGAGCCGAGATAGAAAA|ATTGCAGAAGGACCCTTAATTGCAGAAGGA
GCCTATGCGTGTTAGGAGAGCCCCCCGGCC|TAATTGCAGAAGGAATCGCCTCGAGACTGA
CGGTAGGCATAGATCAATCTTTCCGAGGCA|TTGTTCAGTAGGTGGACAGTAGGTCATTTC
AGGCATAGATCAATCTTTCCGAGGCATAGC|TCAGTAGGTGGACAGTAGGTCATTTCCCCA
ATACTAGGTGGAAGCTTTAGAGCCTCGGTA|GACAAGATGAGCGCCGCCCGTTCGCACCTA
AAGGATATCGAGACTGATACCCTTAATTGC|TGATTTTTGGGCCGGGGCTAGCAAAGATGC
AACCCCCAATCGTGATGATTTTTGGGCCGG|CGCACCTACGTGACACCCTGGATGTGGGTT
GACCCTTAATTGCAGAAGGAATCGTGACCA|AGCCCCCCGGCCTACTAAGTAAATAGCACC
GCAGGTCGACACGCATATCAACCTGCGTGC|AGGATTATTTAACTACCTCGGGTGGCGCAG
ATAGCACCGACTCTAGTCTCCTTAACTCTT|TGCAGAAGGATATCGAGACTGATACCCTTA
ATCAGCGTCTCAGGCAGCTGACGTTAAAGA|TGTACATTAATAGACAAGTTGTCCAATGCT
AATAGACAAGTTGTCCAATGCTAGTAAGAG|TACCCTTAATTGCAGAAGGAACTATGGTGC
GAGACTGATACCCTTAATTGCAGAAGGAAC|GACTGATACCCTTAATTGCAGAAGGAGAGA
CCCTTAATTGCAGAAGGAAATTTAAAGCCA|TCGAGACTGATACCCTTAATTGCAGAAGGA
CGAGACTGATATCGAGACTGATACCCTTAA|GAATGAGTTTCACAGGATGTGGCCTATGCG
ATTCCCCGACGGTCTAGTCGAGACTGATAC|CGACTCTAGTCTCCTTAACTCTTAAGATAC
AAGGAGACGCGTTCGTGATACTTCGAGACT|GCAGAAGGAAATTTAAAGCCATACTAGAGT
TATGTTCGAGACTGATACCCTTAATTGCAG|ATTCCCCGACGGTCTAGTCGAGACTGATAC
GCTAGTAAGAGGATTATTTAACTACCTCGG|AACTATGGTGCCAGCTCGGCCTATTCTATA
ACTTCCGGATCAGCGTCTCAGGCAGCTGAC|ATTGATAGTGTACATTAATAGACAAGTTGT
TGATACCCTTAATTGCAGAAGGAACTATGG|ATACCCTTAATTGCAGAAGGAGAGACTGAT
ATCAACCTGCGTGCACAGCGTCTTGTTCAG|CTCGGGTGGCGCAGTGGTGTCGAAAGTACC
ATGTGGCCTATGCGTGTTAGGAGAGCCCCC|ACCCTTAATTGCAGAAGGAATCGCCTCGAG
TAGGGAAAGTCTAAAAAATCGAGACTGATA|ATCTCGACCGCGATCGCCCCGATGTTCCTA
AATCGAGACTGATACCCTTAATTGCAGAAG|GTATGTTCGAGACTGATACCCTTAATTGCA
GTGTACATTAATAGACAAGTTGTCCAATGC|CGAGACTGATACCCTTAATTGCAGAAGGAA
CAAAGATGCTTGGCCTGTTTACACGCATCC|TCATTGCGGCCCTCTACGATAGGGTTGTCC
TAACTCTTAAGATACAATACGGTCTCGAGA|TACCCTTAATTGCAGAAGGACGGAGTAACC
AGACGCGTTCGTGATACTTCGAGACTGATA|AAGGAAATTTAAAGCCATACTAGAGTTGGC
TACCCTTAATTGCAGAAGGACAACCCCCAA|TATCCGATTCCGGGTGGTACTCGCACCTAC
TCGAGACTGATACCCTTAATTGCAGAAGGA|CCGATGTTCCTATCCGATTCCGGGTGGTAC
GATGCACCAGAACTTGTGGACCTGTCTGGA|TCGAGACTGATACCCTTAATTGCAGAAGGA
GGCTAGCAAAGATGCTTGGCCTGTTTACAC|TATTAGTCATTGCGGCCCTCTACGATAGGG
ACTATGGTGCCAGCTCGGCCTATTCTATAC|GACTGATACCCTTAATTGCAGAAGGAGACA
CTTAATTGCAGAAGGACAACCCCCAATCGT|CGATTCCGGGTGGTACTCGCACCTACGTGA
GGAACCCGTCTCGAGACTGATACCCTTAAT|AGAAGGAGACGCGTTCGTGATACTTCGAGA
AAATTTAAAGCCATACTAGAGTTGGCATCG|AATTGCAGAAGGATGTCTGTGAATAGAGGA
TGTTAGGAGAGCCCCCCGGCCTACTAAGTA|AAGGAATCGCCTCGAGACTGATACCCTTAA
GATGTCTGTGAATAGAGGAATGAGTTTCAC|CTGATACCCTTAATTGCAGAAGGAGAGACT
TCATAGGGAAAGTCTAAAAAATCGAGACTG|GATATCTCGACCGCGATCGCCCCGATGTTC
CGAAAGTACCATTCGTGGATGCACCAGAAC|AGAGCCTCGGTATCCTCTCGAGACTGATAC
AGCTCGGCCTATTCTATACTAGGTGGAAGC|TTAATTGCAGAAGGAGACAAGATGAGCGCC
ATCAGAGCCGAGATAGAAAAAGTCCGTCGT|GACCCTTAATTGCAGAAGGAATCGTGACCA
CGCGATCGCCCCGATGTTCCTATCCGATTC|AGCACGGGGTATGTACCGATAGTGGTGTTG
GAACCCGTCTCGAGACTGATACCCTTAATT|GAAGGAGACGCGTTCGTGATACTTCGAGAC
GTCATACGACCCAATCAGAGCCGAGATAGA|TTAATTGCAGAAGGACCCTTAATTGCAGAA
TACTAAGTAAATAGCACCGACTCTAGTCTC|TACCCTTAATTGCAGAAGGATATCGAGACT
TAGTCGAGACTGATACCCTTAATTGCAGAA|TTAACTCTTAAGATACAATACGGTCTCGAG
GAAGGAGAGACTGATACCCTTAATTGCAGA|ATAGGGAAAGTCTAAAAAATCGAGACTGAT
CCTTCATAGGGAAAGTCTAAAAAATCGAGA|CATGATATCTCGACCGCGATCGCCCCGATG
TCACAGGATGTGGCCTATGCGTGTTAGGAG|GACTGATACCCTTAATTGCAGAAGGAATCG
TACGACCCAATCAGAGCCGAGATAGAAAAA|TTGCAGAAGGACCCTTAATTGCAGAAGGAA
TCTCGAGACTGATACCCTTAATTGCAGAAG|ACGCGTTCGTGATACTTCGAGACTGATACC
CATATCAACCTGCGTGCACAGCGTCTTGTT|TACCTCGGGTGGCGCAGTGGTGTCGAAAGT
CCTTAATTGCAGAAGGAGACGCGTTCGTGA|ATACCCTTAATTGCAGAAGGAAATTTAAAG
ACCTCGGGTGGCGCAGTGGTGTCGAAAGTA|TTCTATACTAGGTGGAAGCTTTAGAGCCTC
ATCTCCCAAATCGAGACTGATACCCTTAAT|AGTCCGTCGTATGTTCGAGACTGATACCCT
TCGAGACTGATACCCTTAATTGCAGAAGGA|ACTCTTAAGATACAATACGGTCTCGAGACT
AGCGCCGCCCGTTCGCACCTATCTCCCAAA|ATCAGAGCCGAGATAGAAAAAGTCCGTCGT
CAGAAGGACAACCCCCAATCGTGATGATTT|GGTGGTACTCGCACCTACGTGACACCCTGG
CCCTTAATTGCAGAAGGAGAGACTGATACC|CTTCGAGACTGATACCCTTAATTGCAGAAG
GGTGCCAGCTCGGCCTATTCTATACTAGGT|ATACCCTTAATTGCAGAAGGAGACAAGATG
AATGCTAGTAAGAGGATTATTTAACTACCT|AGGAACTATGGTGCCAGCTCGGCCTATTCT
CTTAATTGCAGAAGGACCCTTAATTGCAGA|ATGCGTGTTAGGAGAGCCCCCCGGCCTACT
CTCCCAAATCGAGACTGATACCCTTAATTG|TCCGTCGTATGTTCGAGACTGATACCCTTA
CCCTTAATTGCAGAAGGACCCTTAATTGCA|CTATGCGTGTTAGGAGAGCCCCCCGGCCTA
AGTAGGTGGACAGTAGGTCATTTCCCCACG|CCATTCGTGGATGCACCAGAACTTGTGGAC
AGACTGATACCCTTAATTGCAGAAGGAGAC|AATTGCAGAAGGATGTCCTGGGGGTCATAC
TGACGTTAAAGAGGCTTCGCAGGTCGACAC|TTGTCCAATGCTAGTAAGAGGATTATTTAA
GCGTCTTGTTCAGTAGGTGGACAGTAGGTC|TGTCGAAAGTACCATTCGTGGATGCACCAG
CCGCCCGTTCGCACCTATCTCCCAAATCGA|GAGCCGAGATAGAAAAAGTCCGTCGTATGT
AGTCGAGACTGATACCCTTAATTGCAGAAG|TAACTCTTAAGATACAATACGGTCTCGAGA
GAAGATTGATAGTGTACATTAATAGACAAG|ATACAAGTCGTCGAGACTGATACCCTTAAT
ACCCTTAATTGCAGAAGGAGACAAGATGAG|AAGGATGTCCTGGGGGTCATACGACCCAAT
GCCCGTTCGCACCTATCTCCCAAATCGAGA|GCCGAGATAGAAAAAGTCCGTCGTATGTTC
TGCAGAAGGAACTATGGTGCCAGCTCGGCC|CAGAAGGAGAGACTGATACCCTTAATTGCA
CAATCAGAGCCGAGATAGAAAAAGTCCGTC|AGGACCCTTAATTGCAGAAGGAATCGTGAC
ATCGTGATGATTTTTGGGCCGGGGCTAGCA|CGTGACACCCTGGATGTGGGTTTATTAGTC
CAGAAGGAACTATGGTGCCAGCTCGGCCTA|GAAGGAGAGACTGATACCCTTAATTGCAGA
CTCTTAAGATACAATACGGTCTCGAGACTG|CCTTAATTGCAGAAGGACGGAGTAACCCAG
ACCCTTAATTGCAGAAGGAAATTTAAAGCC|GTCGAGACTGATACCCTTAATTGCAGAAGG
ATCGAGACTGATATCGAGACTGATACCCTT|AGGAATGAGTTTCACAGGATGTGGCCTATG
CTGTTTACACGCATCCAACTAGAGTCATGA|TACGATAGGGTTGTCCCTCATGGGCGCTCC
GAGCGCCGCCCGTTCGCACCTATCTCCCAA|AATCAGAGCCGAGATAGAAAAAGTCCGTCG
CTGATACCCTTAATTGCAGAAGGAGAGACT|CAGTAGTTGTTATCCTTCATAGGGAAAGTC
AAAATCGAGACTGATACCCTTAATTGCAGA|CGCCCCGATGTTCCTATCCGATTCCGGGTG
TTAATTGCAGAAGGACGGAGTAACCCAGTA|AAAGATGCTTGGCCTGTTTACACGCATCCA
TCGAGACTGATACCCTTAATTGCAGAAGGA|ACAGGATGTGGCCTATGCGTGTTAGGAGAG
TGATACCCTTAATTGCAGAAGGAACCCGTC|AGACTGATACCCTTAATTGCAGAAGGAGAC
GAAGGAAATTTAAAGCCATACTAGAGTTGG|CCCTTAATTGCAGAAGGATGTCTGTGAATA
CATTTCCCCACGCTGCGACCGAAGATTGAT|GAACTTGTGGACCTGTCTGGATACAAGTCG
CTCGAGACTGATACCCTTAATTGCAGAAGG|CCAAATCGAGACTGATACCCTTAATTGCAG
AGCCGAGATAGAAAAAGTCCGTCGTATGTT|TTAATTGCAGAAGGAATCGTGACCATTCCC
GAAAGTACCATTCGTGGATGCACCAGAACT|GAGCCTCGGTATCCTCTCGAGACTGATACC
AACTAGAGTCATGATATCTCGACCGCGATC|CTCATGGGCGCTCCGTATGGCCCAGCACGG
GGATGTCTGTGAATAGAGGAATGAGTTTCA|ACTGATACCCTTAATTGCAGAAGGAGAGAC
TATCAACCTGCGTGCACAGCGTCTTGTTCA|CCTCGGGTGGCGCAGTGGTGTCGAAAGTAC
TATCCTTCATAGGGAAAGTCTAAAAAATCG|AGTCATGATATCTCGACCGCGATCGCCCCG
TTGCAGAAGGATGTCTGTGAATAGAGGAAT|GTCTCGAGACTGATACCCTTAATTGCAGAA
ACCGCGATCGCCCCGATGTTCCTATCCGAT|CCAGCACGGGGTATGTACCGATAGTGGTGT
ACCGAAGATTGATAGTGTACATTAATAGAC|TGGATACAAGTCGTCGAGACTGATACCCTT
TTAATTGCAGAAGGAGAGACTGATACCCTT|CGAGACTGATACCCTTAATTGCAGAAGGAT
CCTCGAGACTGATACCCTTAATTGCAGAAG|TTGCAGAAGGACAACCCCCAATCGTGATGA
CAGAAGGATATCGAGACTGATACCCTTAAT|TGATGATTTTTGGGCCGGGGCTAGCAAAGA
TTAGAGCCTCGGTATCCTCTCGAGACTGAT|CCCGTTCGCACCTATCTCCCAAATCGAGAC
CATTCGTGGATGCACCAGAACTTGTGGACC|GTATCCTCTCGAGACTGATACCCTTAATTG
AAGATGAGCGCCGCCCGTTCGCACCTATCT|GACCCAATCAGAGCCGAGATAGAAAAAGTC
AAGTAAATAGCACCGACTCTAGTCTCCTTA|CTTAATTGCAGAAGGATATCGAGACTGATA
TCCCAAATCGAGACTGATACCCTTAATTGC|CCGTCGTATGTTCGAGACTGATACCCTTAA
AAACCCCTCAGAGCGGTAGGCATAGATCAA|CGTGCACAGCGTCTTGTTCAGTAGGTGGAC
GACTGATACCCTTAATTGCAGAAGGAGAGA|CCCAGTAGTTGTTATCCTTCATAGGGAAAG
TGGGGGTCATACGACCCAATCAGAGCCGAG|TACCCTTAATTGCAGAAGGACCCTTAATTG
TTAATTGCAGAAGGAGACGCGTTCGTGATA|ACCCTTAATTGCAGAAGGAAATTTAAAGCC
CCGACTCTAGTCTCCTTAACTCTTAAGATA|AGGATATCGAGACTGATACCCTTAATTGCA
TCTTGTTCAGTAGGTGGACAGTAGGTCATT|CGAAAGTACCATTCGTGGATGCACCAGAAC
TTAATTGCAGAAGGAAATTTAAAGCCATAC|AGACTGATACCCTTAATTGCAGAAGGATGT
TTGCAGAAGGAACTATGGTGCCAGCTCGGC|GCAGAAGGAGAGACTGATACCCTTAATTGC
AGTACCATTCGTGGATGCACCAGAACTTGT|CCTCGGTATCCTCTCGAGACTGATACCCTT
CATAGCAGTCGCCATCAAGCACTTCCGGAT|TCCCCACGCTGCGACCGAAGATTGATAGTG
GGGCTAGCAAAGATGCTTGGCCTGTTTACA|TTATTAGTCATTGCGGCCCTCTACGATAGG
GATGATTTTTGGGCCGGGGCTAGCAAAGAT|CACCCTGGATGTGGGTTTATTAGTCATTGC
CGCAGTGGTGTCGAAAGTACCATTCGTGGA|GTGGAAGCTTTAGAGCCTCGGTATCCTCTC
TTAATTGCAGAAGGAATCGCCTCGAGACTG|TCGAGACTGATACCCTTAATTGCAGAAGGA
CTATCTCCCAAATCGAGACTGATACCCTTA|AAAGTCCGTCGTATGTTCGAGACTGATACC
CAGAAGGAGAGACTGATACCCTTAATTGCA|GATACCCTTAATTGCAGAAGGATGTCCTGG
GATAGTGTACATTAATAGACAAGTTGTCCA|TCGTCGAGACTGATACCCTTAATTGCAGAA
GCAGAAGGAATCGTGACCATTCCCCGACGG|CTACTAAGTAAATAGCACCGACTCTAGTCT
TAGAGTTGGCATCGAGACTGATATCGAGAC|CTGTGAATAGAGGAATGAGTTTCACAGGAT
CCTTAACTCTTAAGATACAATACGGTCTCG|TGATACCCTTAATTGCAGAAGGACGGAGTA
ACGGTCTCGAGACTGATACCCTTAATTGCA|GACGGAGTAACCCAGTAGTTGTTATCCTTC
TTCAGTAGGTGGACAGTAGGTCATTTCCCC|GTACCATTCGTGGATGCACCAGAACTTGTG
GCCTCGAGACTGATACCCTTAATTGCAGAA|ATTGCAGAAGGACAACCCCCAATCGTGATG
TCAGTAGGTGGACAGTAGGTCATTTCCCCA|TACCATTCGTGGATGCACCAGAACTTGTGG
CGACACGCATATCAACCTGCGTGCACAGCG|ATTTAACTACCTCGGGTGGCGCAGTGGTGT
CCGACGGTCTAGTCGAGACTGATACCCTTA|CTAGTCTCCTTAACTCTTAAGATACAATAC
GCAGAAGGAACCCGTCTCGAGACTGATACC|AATTGCAGAAGGAGACGCGTTCGTGATACT
AAGGAGAGACTGATACCCTTAATTGCAGAA|TAGGGAAAGTCTAAAAAATCGAGACTGATA
AAATCGAGACTGATACCCTTAATTGCAGAA|GCCCCGATGTTCCTATCCGATTCCGGGTGG
CTATGCGTGTTAGGAGAGCCCCCCGGCCTA|ATTGCAGAAGGAATCGCCTCGAGACTGATA
GCGTTCGTGATACTTCGAGACTGATACCCT|AAATTTAAAGCCATACTAGAGTTGGCATCG
AAGGAATCGTGACCATTCCCCGACGGTCTA|TAAGTAAATAGCACCGACTCTAGTCTCCTT
CGCTGCGACCGAAGATTGATAGTGTACATT|ACCTGTCTGGATACAAGTCGTCGAGACTGA
AATCGAGACTGATACCCTTAATTGCAGAAG|CCCCGATGTTCCTATCCGATTCCGGGTGGT
CCTTAATTGCAGAAGGAATCGTGACCATTC|CCCCCGGCCTACTAAGTAAATAGCACCGAC
AGGATTATTTAACTACCTCGGGTGGCGCAG|GCCAGCTCGGCCTATTCTATACTAGGTGGA
ACCCTTAATTGCAGAAGGAACCCGTCTCGA|TGATACCCTTAATTGCAGAAGGAGACGCGT
TATACTAGGTGGAAGCTTTAGAGCCTCGGT|AGACAAGATGAGCGCCGCCCGTTCGCACCT
CTGATACCCTTAATTGCAGAAGGATGTCCT|GTTGGCATCGAGACTGATATCGAGACTGAT
TGATACCCTTAATTGCAGAAGGACCCTTAA|GTGGCCTATGCGTGTTAGGAGAGCCCCCCG
CTCCTTAACTCTTAAGATACAATACGGTCT|ACTGATACCCTTAATTGCAGAAGGACGGAG
GGATGTCCTGGGGGTCATACGACCCAATCA|GAGACTGATACCCTTAATTGCAGAAGGACC
TAGAAAAAGTCCGTCGTATGTTCGAGACTG|AGAAGGAATCGTGACCATTCCCCGACGGTC
TTGTGGACCTGTCTGGATACAAGTCGTCGA|CCTTAATTGCAGAAGGAACCCGTCTCGAGA
TCGTCGAGACTGATACCCTTAATTGCAGAA|CTCGAGACTGATACCCTTAATTGCAGAAGG
AGGCTTCGCAGGTCGACACGCATATCAACC|TAGTAAGAGGATTATTTAACTACCTCGGGT
ATTGCAGAAGGAGAGACTGATACCCTTAAT|GACTGATACCCTTAATTGCAGAAGGATGTC
GGTAGGCATAGATCAATCTTTCCGAGGCAT|TGTTCAGTAGGTGGACAGTAGGTCATTTCC
CTTAATTGCAGAAGGAAATTTAAAGCCATA|GAGACTGATACCCTTAATTGCAGAAGGATG
TAAAGCCATACTAGAGTTGGCATCGAGACT|CAGAAGGATGTCTGTGAATAGAGGAATGAG
GTGTCGAAAGTACCATTCGTGGATGCACCA|CTTTAGAGCCTCGGTATCCTCTCGAGACTG
TACCCTTAATTGCAGAAGGAACTATGGTGC|CCCTTAATTGCAGAAGGAGAGACTGATACC
CATTAATAGACAAGTTGTCCAATGCTAGTA|CTGATACCCTTAATTGCAGAAGGAACTATG
ACGCGTTCGTGATACTTCGAGACTGATACC|GGAAATTTAAAGCCATACTAGAGTTGGCAT
CCTTAATTGCAGAAGGACCCTTAATTGCAG|TATGCGTGTTAGGAGAGCCCCCCGGCCTAC
ATGTCTGTGAATAGAGGAATGAGTTTCACA|TGATACCCTTAATTGCAGAAGGAGAGACTG
CCTCGGTATCCTCTCGAGACTGATACCCTT|CGCACCTATCTCCCAAATCGAGACTGATAC
CGATCGCCCCGATGTTCCTATCCGATTCCG|CACGGGGTATGTACCGATAGTGGTGTTGTT
GAGACTGATACCCTTAATTGCAGAAGGACC|AGGATGTGGCCTATGCGTGTTAGGAGAGCC
ATACCCTTAATTGCAGAAGGAACCCGTCTC|ACTGATACCCTTAATTGCAGAAGGAGACGC
AAGCACTTCCGGATCAGCGTCTCAGGCAGC|GAAGATTGATAGTGTACATTAATAGACAAG
TTAATTGCAGAAGGAACTATGGTGCCAGCT|AATTGCAGAAGGAGAGACTGATACCCTTAA
TAGGAGAGCCCCCCGGCCTACTAAGTAAAT|GAATCGCCTCGAGACTGATACCCTTAATTG
CATACGACCCAATCAGAGCCGAGATAGAAA|AATTGCAGAAGGACCCTTAATTGCAGAAGG
GCATCCAACTAGAGTCATGATATCTCGACC|TTGTCCCTCATGGGCGCTCCGTATGGCCCA
TGATACCCTTAATTGCAGAAGGAAATTTAA|TCTAGTCGAGACTGATACCCTTAATTGCAG
CACGCTGCGACCGAAGATTGATAGTGTACA|GGACCTGTCTGGATACAAGTCGTCGAGACT
GTATCCTCTCGAGACTGATACCCTTAATTG|CTATCTCCCAAATCGAGACTGATACCCTTA
GGAGAGACTGATACCCTTAATTGCAGAAGG|GGGAAAGTCTAAAAAATCGAGACTGATACC
ATACCCTTAATTGCAGAAGGAGAGACTGAT|ATACTTCGAGACTGATACCCTTAATTGCAG
AATCGTGACCATTCCCCGACGGTCTAGTCG|TAAATAGCACCGACTCTAGTCTCCTTAACT
TAATTGCAGAAGGAACCCGTCTCGAGACTG|CCCTTAATTGCAGAAGGAGACGCGTTCGTG
GTAGTTGTTATCCTTCATAGGGAAAGTCTA|CCAACTAGAGTCATGATATCTCGACCGCGA
GACTCTAGTCTCCTTAACTCTTAAGATACA|GATATCGAGACTGATACCCTTAATTGCAGA
ATCTTTCCGAGGCATAGCAGTCGCCATCAA|CAGTAGGTCATTTCCCCACGCTGCGACCGA
GAGACTGATACCCTTAATTGCAGAAGGAGA|TAATTGCAGAAGGATGTCCTGGGGGTCATA
TAACCCAGTAGTTGTTATCCTTCATAGGGA|CACGCATCCAACTAGAGTCATGATATCTCG
AATGAGTTTCACAGGATGTGGCCTATGCGT|GAAGGAGAGACTGATACCCTTAATTGCAGA
ATAGCAGTCGCCATCAAGCACTTCCGGATC|CCCCACGCTGCGACCGAAGATTGATAGTGT
GATACCCTTAATTGCAGAAGGAGACGCGTT|GACTGATACCCTTAATTGCAGAAGGAAATT
TTCGTGATACTTCGAGACTGATACCCTTAA|TTTAAAGCCATACTAGAGTTGGCATCGAGA
CAACCCCCAATCGTGATGATTTTTGGGCCG|TCGCACCTACGTGACACCCTGGATGTGGGT
GTTGTCCAATGCTAGTAAGAGGATTATTTA|TTGCAGAAGGAACTATGGTGCCAGCTCGGC
CCCCCGGCCTACTAAGTAAATAGCACCGAC|CGAGACTGATACCCTTAATTGCAGAAGGAT
AGACTGATACCCTTAATTGCAGAAGGAATC|AAGTCTAAAAAATCGAGACTGATACCCTTA
CGAGACTGATACCCTTAATTGCAGAAGGAT|CTCTTAAGATACAATACGGTCTCGAGACTG
TCGCAGGTCGACACGCATATCAACCTGCGT|AGAGGATTATTTAACTACCTCGGGTGGCGC
CGAGACTGATACCCTTAATTGCAGAAGGAC|CGATGTTCCTATCCGATTCCGGGTGGTACT
GATTATTTAACTACCTCGGGTGGCGCAGTG|CAGCTCGGCCTATTCTATACTAGGTGGAAG
TGAATAGAGGAATGAGTTTCACAGGATGTG|CTTAATTGCAGAAGGAGAGACTGATACCCT
CTATTCTATACTAGGTGGAAGCTTTAGAGC|AGAAGGAGACAAGATGAGCGCCGCCCGTTC
GCCGGGGCTAGCAAAGATGCTTGGCCTGTT|GGGTTTATTAGTCATTGCGGCCCTCTACGA
AAAAGTCCGTCGTATGTTCGAGACTGATAC|GGAATCGTGACCATTCCCCGACGGTCTAGT
GTCTAAAAAATCGAGACTGATACCCTTAAT|CGCGATCGCCCCGATGTTCCTATCCGATTC
CAGAACTTGTGGACCTGTCTGGATACAAGT|TGATACCCTTAATTGCAGAAGGAACCCGTC
TGTTATCCTTCATAGGGAAAGTCTAAAAAA|TAGAGTCATGATATCTCGACCGCGATCGCC
ATGTCCTGGGGGTCATACGACCCAATCAGA|GACTGATACCCTTAATTGCAGAAGGACCCT
GGATATCGAGACTGATACCCTTAATTGCAG|ATTTTTGGGCCGGGGCTAGCAAAGATGCTT
CAGTCGCCATCAAGCACTTCCGGATCAGCG|ACGCTGCGACCGAAGATTGATAGTGTACAT
TCAGAGCCGAGATAGAAAAAGTCCGTCGTA|ACCCTTAATTGCAGAAGGAATCGTGACCAT
TACCCTTAATTGCAGAAGGACCCTTAATTG|GCCTATGCGTGTTAGGAGAGCCCCCCGGCC
GTCTTGTTCAGTAGGTGGACAGTAGGTCAT|TCGAAAGTACCATTCGTGGATGCACCAGAA
TCGGCCTATTCTATACTAGGTGGAAGCTTT|ATTGCAGAAGGAGACAAGATGAGCGCCGCC
AAGTCCGTCGTATGTTCGAGACTGATACCC|AATCGTGACCATTCCCCGACGGTCTAGTCG
GGGTCATACGACCCAATCAGAGCCGAGATA|CCTTAATTGCAGAAGGACCCTTAATTGCAG
CGTCGAGACTGATACCCTTAATTGCAGAAG|TCGAGACTGATACCCTTAATTGCAGAAGGA
AAAGTCTAAAAAATCGAGACTGATACCCTT|GACCGCGATCGCCCCGATGTTCCTATCCGA
TAGGTGGAAGCTTTAGAGCCTCGGTATCCT|AGATGAGCGCCGCCCGTTCGCACCTATCTC
GATATCGAGACTGATACCCTTAATTGCAGA|TTTCACAGGATGTGGCCTATGCGTGTTAGG
GGCATAGATCAATCTTTCCGAGGCATAGCA|CAGTAGGTGGACAGTAGGTCATTTCCCCAC
GGTATCCTCTCGAGACTGATACCCTTAATT|CCTATCTCCCAAATCGAGACTGATACCCTT
TCGCCATCAAGCACTTCCGGATCAGCGTCT|CTGCGACCGAAGATTGATAGTGTACATTAA
AACCTGCGTGCACAGCGTCTTGTTCAGTAG|GGGTGGCGCAGTGGTGTCGAAAGTACCATT
TCGGTATCCTCTCGAGACTGATACCCTTAA|CACCTATCTCCCAAATCGAGACTGATACCC
ACTGATACCCTTAATTGCAGAAGGATGTCC|AGTTGGCATCGAGACTGATATCGAGACTGA
CAGTAGGTGGACAGTAGGTCATTTCCCCAC|ACCATTCGTGGATGCACCAGAACTTGTGGA
GTTCCTATCCGATTCCGGGTGGTACTCGCA|CCGATAGTGGTGTTGTTCGAGCAGTCCGCA
AGAACTTGTGGACCTGTCTGGATACAAGTC|GATACCCTTAATTGCAGAAGGAACCCGTCT
ACCCTTAATTGCAGAAGGACGGAGTAACCC|TAGCAAAGATGCTTGGCCTGTTTACACGCA
TTCCGAGGCATAGCAGTCGCCATCAAGCAC|AGGTCATTTCCCCACGCTGCGACCGAAGAT
TTAATTGCAGAAGGAACCCGTCTCGAGACT|ACCCTTAATTGCAGAAGGAGACGCGTTCGT
ATTGCAGAAGGACGGAGTAACCCAGTAGTT|GATGCTTGGCCTGTTTACACGCATCCAACT
GGAAATTTAAAGCCATACTAGAGTTGGCAT|TTAATTGCAGAAGGATGTCTGTGAATAGAG
CCCTTAATTGCAGAAGGAATCGTGACCATT|CCCCCCGGCCTACTAAGTAAATAGCACCGA
GAATCGTGACCATTCCCCGACGGTCTAGTC|GTAAATAGCACCGACTCTAGTCTCCTTAAC
CGACCGCGATCGCCCCGATGTTCCTATCCG|GCCCAGCACGGGGTATGTACCGATAGTGGT
AATTGCAGAAGGAGACAAGATGAGCGCCGC|GTCCTGGGGGTCATACGACCCAATCAGAGC
CTTGTTCAGTAGGTGGACAGTAGGTCATTT|GAAAGTACCATTCGTGGATGCACCAGAACT
GACTGATATCGAGACTGATACCCTTAATTG|TGAGTTTCACAGGATGTGGCCTATGCGTGT
CGTCTTGTTCAGTAGGTGGACAGTAGGTCA|GTCGAAAGTACCATTCGTGGATGCACCAGA
AGAAGGAACCCGTCTCGAGACTGATACCCT|TTGCAGAAGGAGACGCGTTCGTGATACTTC
TACCCTTAATTGCAGAAGGATGTCTGTGAA|TACAATACGGTCTCGAGACTGATACCCTTA
CGTGGATGCACCAGAACTTGTGGACCTGTC|CCTCTCGAGACTGATACCCTTAATTGCAGA
CGTGATACTTCGAGACTGATACCCTTAATT|TAAAGCCATACTAGAGTTGGCATCGAGACT
TACCCTTAATTGCAGAAGGAGAGACTGATA|TACTTCGAGACTGATACCCTTAATTGCAGA
ATTCGTGGATGCACCAGAACTTGTGGACCT|TATCCTCTCGAGACTGATACCCTTAATTGC
ATATCAACCTGCGTGCACAGCGTCTTGTTC|ACCTCGGGTGGCGCAGTGGTGTCGAAAGTA
CCCGATGTTCCTATCCGATTCCGGGTGGTA|TATGTACCGATAGTGGTGTTGTTCGAGCAG
TTTGGGCCGGGGCTAGCAAAGATGCTTGGC|GATGTGGGTTTATTAGTCATTGCGGCCCTC
ATAGTGTACATTAATAGACAAGTTGTCCAA|CGTCGAGACTGATACCCTTAATTGCAGAAG
GGCCTACTAAGTAAATAGCACCGACTCTAG|CTGATACCCTTAATTGCAGAAGGATATCGA
AGTTTCACAGGATGTGGCCTATGCGTGTTA|GAGAGACTGATACCCTTAATTGCAGAAGGA
GAAGGAATCGCCTCGAGACTGATACCCTTA|ATACCCTTAATTGCAGAAGGACAACCCCCA
AGCACTTCCGGATCAGCGTCTCAGGCAGCT|AAGATTGATAGTGTACATTAATAGACAAGT
CTTAATTGCAGAAGGATGTCCTGGGGGTCA|CGAGACTGATATCGAGACTGATACCCTTAA
GACTGATACCCTTAATTGCAGAAGGAGACA|ATTGCAGAAGGATGTCCTGGGGGTCATACG
GCTTTAGAGCCTCGGTATCCTCTCGAGACT|CCGCCCGTTCGCACCTATCTCCCAAATCGA
TTTCCGAGGCATAGCAGTCGCCATCAAGCA|TAGGTCATTTCCCCACGCTGCGACCGAAGA
ACTAAGTAAATAGCACCGACTCTAGTCTCC|ACCCTTAATTGCAGAAGGATATCGAGACTG
CCATTCGTGGATGCACCAGAACTTGTGGAC|GGTATCCTCTCGAGACTGATACCCTTAATT
TCAAGCACTTCCGGATCAGCGTCTCAGGCA|CCGAAGATTGATAGTGTACATTAATAGACA
CCTTAATTGCAGAAGGATATCGAGACTGAT|CCCCAATCGTGATGATTTTTGGGCCGGGGC
CCGGGGCTAGCAAAGATGCTTGGCCTGTTT|GGTTTATTAGTCATTGCGGCCCTCTACGAT
TTGCAGAAGGACAACCCCCAATCGTGATGA|CCGGGTGGTACTCGCACCTACGTGACACCC
AGTCGCCATCAAGCACTTCCGGATCAGCGT|CGCTGCGACCGAAGATTGATAGTGTACATT
TAATTGCAGAAGGAGACGCGTTCGTGATAC|CCCTTAATTGCAGAAGGAAATTTAAAGCCA
TCTAGTCTCCTTAACTCTTAAGATACAATA|ATCGAGACTGATACCCTTAATTGCAGAAGG
ATACCCTTAATTGCAGAAGGATGTCTGTGA|ATACAATACGGTCTCGAGACTGATACCCTT
TCGTGATGATTTTTGGGCCGGGGCTAGCAA|GTGACACCCTGGATGTGGGTTTATTAGTCA
ATGAGTTTCACAGGATGTGGCCTATGCGTG|AAGGAGAGACTGATACCCTTAATTGCAGAA
GATACAATACGGTCTCGAGACTGATACCCT|TGCAGAAGGACGGAGTAACCCAGTAGTTGT
CGCACCTATCTCCCAAATCGAGACTGATAC|TAGAAAAAGTCCGTCGTATGTTCGAGACTG
ATACCCTTAATTGCAGAAGGACCCTTAATT|GGCCTATGCGTGTTAGGAGAGCCCCCCGGC
GGTCATACGACCCAATCAGAGCCGAGATAG|CTTAATTGCAGAAGGACCCTTAATTGCAGA
TTGCAGAAGGATGTCCTGGGGGTCATACGA|CTGATATCGAGACTGATACCCTTAATTGCA
GCGGTAGGCATAGATCAATCTTTCCGAGGC|CTTGTTCAGTAGGTGGACAGTAGGTCATTT
GCGTGCACAGCGTCTTGTTCAGTAGGTGGA|GCGCAGTGGTGTCGAAAGTACCATTCGTGG
GCACAGCGTCTTGTTCAGTAGGTGGACAGT|AGTGGTGTCGAAAGTACCATTCGTGGATGC
GACAGTAGGTCATTTCCCCACGCTGCGACC|GGATGCACCAGAACTTGTGGACCTGTCTGG
AGGAACTATGGTGCCAGCTCGGCCTATTCT|GAGAGACTGATACCCTTAATTGCAGAAGGA
CTGATACCCTTAATTGCAGAAGGACCCTTA|TGTGGCCTATGCGTGTTAGGAGAGCCCCCC
ACCCGTCTCGAGACTGATACCCTTAATTGC|AGGAGACGCGTTCGTGATACTTCGAGACTG
CTCGAGACTGATACCCTTAATTGCAGAAGG|AGTAACCCAGTAGTTGTTATCCTTCATAGG
CAGAAGGAGACGCGTTCGTGATACTTCGAG|ATTGCAGAAGGAAATTTAAAGCCATACTAG
GCCAGCTCGGCCTATTCTATACTAGGTGGA|CCCTTAATTGCAGAAGGAGACAAGATGAGC
GCACCGACTCTAGTCTCCTTAACTCTTAAG|AGAAGGATATCGAGACTGATACCCTTAATT
TGTACATTAATAGACAAGTTGTCCAATGCT|GAGACTGATACCCTTAATTGCAGAAGGAAC
GTAGGTGGACAGTAGGTCATTTCCCCACGC|CATTCGTGGATGCACCAGAACTTGTGGACC
AAGTCGTCGAGACTGATACCCTTAATTGCA|CGTCTCGAGACTGATACCCTTAATTGCAGA
TAATTGCAGAAGGATGTCTGTGAATAGAGG|ACGGTCTCGAGACTGATACCCTTAATTGCA
CTTAATTGCAGAAGGAGACAAGATGAGCGC|GATGTCCTGGGGGTCATACGACCCAATCAG
AAAGTCCGTCGTATGTTCGAGACTGATACC|GAATCGTGACCATTCCCCGACGGTCTAGTC
GTTCAGTAGGTGGACAGTAGGTCATTTCCC|AGTACCATTCGTGGATGCACCAGAACTTGT
GCAGAAGGAACTATGGTGCCAGCTCGGCCT|AGAAGGAGAGACTGATACCCTTAATTGCAG
GAAGGAGAGACTGATACCCTTAATTGCAGA|TACCCTTAATTGCAGAAGGATGTCCTGGGG
CCGGCCTACTAAGTAAATAGCACCGACTCT|GACTGATACCCTTAATTGCAGAAGGATATC
GTTAGGAGAGCCCCCCGGCCTACTAAGTAA|AGGAATCGCCTCGAGACTGATACCCTTAAT
TAAATAGCACCGACTCTAGTCTCCTTAACT|AATTGCAGAAGGATATCGAGACTGATACCC
ATACGGTCTCGAGACTGATACCCTTAATTG|AGGACGGAGTAACCCAGTAGTTGTTATCCT
GTCGAGACTGATACCCTTAATTGCAGAAGG|AACTCTTAAGATACAATACGGTCTCGAGAC
CCTTAATTGCAGAAGGACAACCCCCAATCG|CCGATTCCGGGTGGTACTCGCACCTACGTG
ACGTTAAAGAGGCTTCGCAGGTCGACACGC|GTCCAATGCTAGTAAGAGGATTATTTAACT
CCTATGCGTGTTAGGAGAGCCCCCCGGCCT|AATTGCAGAAGGAATCGCCTCGAGACTGAT
CAGGATGTGGCCTATGCGTGTTAGGAGAGC|TGATACCCTTAATTGCAGAAGGAATCGCCT
TGCAGAAGGAGACAAGATGAGCGCCGCCCG|CTGGGGGTCATACGACCCAATCAGAGCCGA
CACAGGATGTGGCCTATGCGTGTTAGGAGA|ACTGATACCCTTAATTGCAGAAGGAATCGC
ACTACCTCGGGTGGCGCAGTGGTGTCGAAA|CTATTCTATACTAGGTGGAAGCTTTAGAGC
GACGGAGTAACCCAGTAGTTGTTATCCTTC|CTGTTTACACGCATCCAACTAGAGTCATGA
AGGAAATTTAAAGCCATACTAGAGTTGGCA|CTTAATTGCAGAAGGATGTCTGTGAATAGA
CCCTTAATTGCAGAAGGAACTATGGTGCCA|CTTAATTGCAGAAGGAGAGACTGATACCCT
CTTAACTCTTAAGATACAATACGGTCTCGA|GATACCCTTAATTGCAGAAGGACGGAGTAA
CCTTAATTGCAGAAGGAGAGACTGATACCC|TTCGAGACTGATACCCTTAATTGCAGAAGG
GGGGTCATACGACCCAATCAGAGCCGAGAT|CCCTTAATTGCAGAAGGACCCTTAATTGCA
GATACCCTTAATTGCAGAAGGAGAGACTGA|GATACTTCGAGACTGATACCCTTAATTGCA
CTAGCAAAGATGCTTGGCCTGTTTACACGC|TTAGTCATTGCGGCCCTCTACGATAGGGTT
GACCATTCCCCGACGGTCTAGTCGAGACTG|GCACCGACTCTAGTCTCCTTAACTCTTAAG
GACCGAAGATTGATAGTGTACATTAATAGA|CTGGATACAAGTCGTCGAGACTGATACCCT
TAATTGCAGAAGGACGGAGTAACCCAGTAG|AAGATGCTTGGCCTGTTTACACGCATCCAA
ATACAAGTCGTCGAGACTGATACCCTTAAT|AACCCGTCTCGAGACTGATACCCTTAATTG
TATTTAACTACCTCGGGTGGCGCAGTGGTG|CTCGGCCTATTCTATACTAGGTGGAAGCTT
TCGTATGTTCGAGACTGATACCCTTAATTG|ACCATTCCCCGACGGTCTAGTCGAGACTGA
ATACAATACGGTCTCGAGACTGATACCCTT|GCAGAAGGACGGAGTAACCCAGTAGTTGTT
TGATATCTCGACCGCGATCGCCCCGATGTT|TCCGTATGGCCCAGCACGGGGTATGTACCG
TGATACCCTTAATTGCAGAAGGACAACCCC|TCCTATCCGATTCCGGGTGGTACTCGCACC
GACGCGTTCGTGATACTTCGAGACTGATAC|AGGAAATTTAAAGCCATACTAGAGTTGGCA
ATTTAACTACCTCGGGTGGCGCAGTGGTGT|TCGGCCTATTCTATACTAGGTGGAAGCTTT
GACTGATACCCTTAATTGCAGAAGGACAAC|TGTTCCTATCCGATTCCGGGTGGTACTCGC
CAGAAGGACCCTTAATTGCAGAAGGAATCG|TAGGAGAGCCCCCCGGCCTACTAAGTAAAT
AGAAGGAAATTTAAAGCCATACTAGAGTTG|ACCCTTAATTGCAGAAGGATGTCTGTGAAT
TACACGCATCCAACTAGAGTCATGATATCT|TAGGGTTGTCCCTCATGGGCGCTCCGTATG
TATCCTCTCGAGACTGATACCCTTAATTGC|TATCTCCCAAATCGAGACTGATACCCTTAA
GGCCTGTTTACACGCATCCAACTAGAGTCA|CTCTACGATAGGGTTGTCCCTCATGGGCGC
GTCTCGAGACTGATACCCTTAATTGCAGAA|GACGCGTTCGTGATACTTCGAGACTGATAC
TAATTGCAGAAGGAGACAAGATGAGCGCCG|TGTCCTGGGGGTCATACGACCCAATCAGAG
TGTCTGTGAATAGAGGAATGAGTTTCACAG|GATACCCTTAATTGCAGAAGGAGAGACTGA
CGACTCTAGTCTCCTTAACTCTTAAGATAC|GGATATCGAGACTGATACCCTTAATTGCAG
TGGAAGCTTTAGAGCCTCGGTATCCTCTCG|GAGCGCCGCCCGTTCGCACCTATCTCCCAA
TCGGGTGGCGCAGTGGTGTCGAAAGTACCA|TATACTAGGTGGAAGCTTTAGAGCCTCGGT
ATCCAACTAGAGTCATGATATCTCGACCGC|GTCCCTCATGGGCGCTCCGTATGGCCCAGC
GATGCTTGGCCTGTTTACACGCATCCAACT|TGCGGCCCTCTACGATAGGGTTGTCCCTCA
ACAGGATGTGGCCTATGCGTGTTAGGAGAG|CTGATACCCTTAATTGCAGAAGGAATCGCC
GAATGAGTTTCACAGGATGTGGCCTATGCG|AGAAGGAGAGACTGATACCCTTAATTGCAG
GCAGTCGCCATCAAGCACTTCCGGATCAGC|CACGCTGCGACCGAAGATTGATAGTGTACA
GAATCGCCTCGAGACTGATACCCTTAATTG|CCTTAATTGCAGAAGGACAACCCCCAATCG
CCTCAGAGCGGTAGGCATAGATCAATCTTT|ACAGCGTCTTGTTCAGTAGGTGGACAGTAG
GATACCCTTAATTGCAGAAGGATGTCTGTG|GATACAATACGGTCTCGAGACTGATACCCT
CCCAAATCGAGACTGATACCCTTAATTGCA|CGTCGTATGTTCGAGACTGATACCCTTAAT
CAGTAGGTCATTTCCCCACGCTGCGACCGA|ATGCACCAGAACTTGTGGACCTGTCTGGAT
TAAGATACAATACGGTCTCGAGACTGATAC|AATTGCAGAAGGACGGAGTAACCCAGTAGT
AAGGAATCGCCTCGAGACTGATACCCTTAA|TACCCTTAATTGCAGAAGGACAACCCCCAA
CGTCGTATGTTCGAGACTGATACCCTTAAT|TGACCATTCCCCGACGGTCTAGTCGAGACT
AAGGAACCCGTCTCGAGACTGATACCCTTA|GCAGAAGGAGACGCGTTCGTGATACTTCGA
GAAGGATATCGAGACTGATACCCTTAATTG|ATGATTTTTGGGCCGGGGCTAGCAAAGATG
CGAGACTGATACCCTTAATTGCAGAAGGAC|GGGCCGGGGCTAGCAAAGATGCTTGGCCTG
CCAATCGTGATGATTTTTGGGCCGGGGCTA|CTACGTGACACCCTGGATGTGGGTTTATTA
AAGATACAATACGGTCTCGAGACTGATACC|ATTGCAGAAGGACGGAGTAACCCAGTAGTT
AGGGAAAGTCTAAAAAATCGAGACTGATAC|TCTCGACCGCGATCGCCCCGATGTTCCTAT
CCTGCGTGCACAGCGTCTTGTTCAGTAGGT|GTGGCGCAGTGGTGTCGAAAGTACCATTCG
TGCACCAGAACTTGTGGACCTGTCTGGATA|GAGACTGATACCCTTAATTGCAGAAGGAAC
TCTGGATACAAGTCGTCGAGACTGATACCC|GAAGGAACCCGTCTCGAGACTGATACCCTT
CCTTAATTGCAGAAGGAATCGCCTCGAGAC|AATCGAGACTGATACCCTTAATTGCAGAAG
TGCAGAAGGAATCGTGACCATTCCCCGACG|CCTACTAAGTAAATAGCACCGACTCTAGTC
CTCTCGAGACTGATACCCTTAATTGCAGAA|TCCCAAATCGAGACTGATACCCTTAATTGC
AGAAGGATATCGAGACTGATACCCTTAATT|GATGATTTTTGGGCCGGGGCTAGCAAAGAT
CGTCTCGAGACTGATACCCTTAATTGCAGA|AGACGCGTTCGTGATACTTCGAGACTGATA
ACCCTTAATTGCAGAAGGATGTCCTGGGGG|CATCGAGACTGATATCGAGACTGATACCCT
TATCTCCCAAATCGAGACTGATACCCTTAA|AAGTCCGTCGTATGTTCGAGACTGATACCC
TCCAACTAGAGTCATGATATCTCGACCGCG|TCCCTCATGGGCGCTCCGTATGGCCCAGCA
GAGAGCCCCCCGGCCTACTAAGTAAATAGC|TCGCCTCGAGACTGATACCCTTAATTGCAG
TCTTTCCGAGGCATAGCAGTCGCCATCAAG|AGTAGGTCATTTCCCCACGCTGCGACCGAA
CCTGTTTACACGCATCCAACTAGAGTCATG|CTACGATAGGGTTGTCCCTCATGGGCGCTC
TTTAACTACCTCGGGTGGCGCAGTGGTGTC|CGGCCTATTCTATACTAGGTGGAAGCTTTA
GAGACTGATACCCTTAATTGCAGAAGGAGA|GTTCGTGATACTTCGAGACTGATACCCTTA
GTGAATAGAGGAATGAGTTTCACAGGATGT|CCTTAATTGCAGAAGGAGAGACTGATACCC
TCCCCGACGGTCTAGTCGAGACTGATACCC|ACTCTAGTCTCCTTAACTCTTAAGATACAA
ATCCTCTCGAGACTGATACCCTTAATTGCA|ATCTCCCAAATCGAGACTGATACCCTTAAT
TCTCAGGCAGCTGACGTTAAAGAGGCTTCG|TAATAGACAAGTTGTCCAATGCTAGTAAGA
AATTGCAGAAGGAAATTTAAAGCCATACTA|ACTGATACCCTTAATTGCAGAAGGATGTCT
